actionnewegotalk.1	<title name='NONE'/><face name='normal'/>(Select a Keyword and talk to the Spirit.)
actionrhythmminigame.1	Cannot start due to damaged client data. Please re-install the client and try again.
actionrhythmminigame.2	Points: {0}\nGauge: {1} %
actionrhythmminigame.3	Merlin has gone mad.
airballoondefenseminigame.1	You shot down the enemy's balloon!
airballoondefenseminigame.2	You missed too many times...
airballoondefenseminigame.3	Loading...
airballoondefenseminigame.4	The hot-air balloon is already crashing...
airballoondefenseminigame.5	You're out of flint.
airballoondefenseminigame.6	You can't use flint right now.
airballoondefenseminigame.7	The hot-air balloon is fixed.
bindingdebuff.1	Powerless Duration
boost.1	The effects of {0:potion} seem to be fading.
campfirecandlehandler.1	HP / MP / Stamina Recovery Speed +{0}%
campfirecandlehandler.2	Attack Delay Reduction +{0}%
campfirecandlehandler.3	Fishing Success Rate && Fish Size Adjustment +{0}
campfirecandlehandler.4	Gathering Speed +{0}%
campfirecandlehandler.5	Craft Success Rate +{0}%
campfirecandlehandler.6	The {0}'s aroma suffuses the air around you.\nAs you breathe, you can feel its warmth spread through your body.\n{1}
campfirecandlehandler.7	The {0}'s aroma has dissipated.
chainburst.1	The Chain Burst effect is activated.
chainburst.2	The Chain Burst effect disappeared.
couplelink.1	Loving Bond has been activated.\nMax Damage +{0}\nMin Damage +{1}\n Movement Speed +{2}%
couplelink.2	Loving Bond has been deactivated.
create_char_title	Create a New Character
delegatecontroller_marionette.1	You are too far away to control the puppet.\nControl Marionette disabled.
delegatecontroller_pet.1	You're too far away from the pet.
directory.cache	\\Mabinogi\\Cache
directory.playdata	\\Mabinogi\\Play Data
directory.screenshot	\\Mabinogi\\Screenshot
directory.supplement	\\Mabinogi\\File
emergencyescape.1	Crisis Escape will wear off in {0} seconds.
etc.intro_nexon	Nexon Co., Ltd
etc.intro_text1	Erinn seems...
etc.intro_text2	to be blessed.
etc.intro_text3	When looking beautiful dark sky
etc.intro_text4	I feel
etc.intro_text5	we are loved so
etc.intro_text6	A feeling of blessed world like
etc.intro_text7	The fertility of ground, and
etc.intro_text8	an affection of wood,
etc.intro_text9	all of these are
etc.intro_text10	overwhelmed in our heart
etc.intro_text11	Recite your story
etc.intro_text12	around a warm bornfire.
etc.logout_commercial_webpage	http://www.mabinogi.com/lastguide/
facility_mouseactionpolicy.1	Another pet is currently undertaking a venture. Please complete or cancel the expeditionary venture first.
fantasymelodyhandler.1	You will receive the Melody Step effect.\n\nYour equipment's durability will gradually decrease while the effect lasts.
fantasymelodyhandler.2	The Melody Step effect is fading.
fantasymelodyhandler.3	You will receive the Blessed Melody Step effect.\n\nYour equipment's durability will gradually decrease while the effect lasts.\nIncreases the Music Buff effect by 3.
fantasymelodyhandler.4	The Blessed Melody Step effect is fading.
fantasymelodyhandler.5	스위트 로즈 멜로디 스텝 효과를 받습니다.\n\n효과가 지속되는 동안 장비 아이템의 내구력이 천천히 떨어집니다.\n음악버프 스킬 효과 5 증가의 효과를 받습니다.
fantasymelodyhandler.6	스위트 로즈 멜로디 스텝 효과가 사라집니다.
goldentime.1	Golden Time effects will expire after 10 seconds.
gunfrenzy.1	Way of the Gun activated.
gunfrenzy.2	Way of the Gun has ended.
hackshield.1	Auto Mouse has been detected on your computer. (Type {0})
hackshield.2	Macro has been detected on your computer.
hackshield.3	Hooking for data protection API has been detected.
hackshield.4	\n\nFunction Name: {0}\nModule Name: {1}\n
hackshield.5	Hackshield driver is not loading.
hackshield.6	Message Hooking has been detected, and was unable to block it.
hackshield.7	Debug track has been detected.
hackshield.8	Debug track has been altered.
hackshield.9	A game hacking tool has been detected.
hackshield.10	Illegal memory access has been detected.\n{0}
hackshield.11	The module for Hackshield has been compromised.
hackshield.12	The functions for Hackshield engine is currently abnormal.
hackshield.13	Invalid code detected.
hackshield.14	Memory modification of the Hackshield Module has been detected. Address: {0}
hackshield.15	{0} file has been altered. Please re-install Mabinogi.
hackshield.16	Warning
hackshield.17	Incorrect data has been sent to the Hackshild Module.
hackshield.18	Hackshield Module has yet to be initialized.
hackshield.19	The current process has been loaded in a compatible mode.
hackshield.20	The license key for Hackshield is incorrect.
hackshield.21	A Hackshield file has been corrupted. Please re-install Mabinogi.
hackshield.22	Hackshield is currently running through another program.
hackshield.23	Hackshield has detected a debugger currently running. Please shut down the debugger and restart the game.
hackshield.24	The code for the executing file is modified.
hackshield.25	Only the Administrator may run this.
hackshield.26	Unable to start the Auto-Detect engine for Hackshield.
hackshield.27	Unable to create the driver file for Hackshield.
hackshield.28	Unable to register the driver for Hackshield.
hackshield.29	Unable to start the driver for Hackshield.
hackshield.30	Unable to start the search thread for Hackshield.
hackshield.31	Hackshield Module needs to be updated.
hackshield.32	An error has occurred with Hackshield.
hackshield.33	\nPlease take a screenshot and report this to Customer Service.\nError number: {0}
hackshield.34	Warning
hackshield.35	Unable to read HSUpdate.env.
hackshield.36	Unable to use HSUpdate.env.
hackshield.37	Unable to connect to the update server for Hackshield.
hackshield.38	Unable to find a file for a Hackshield update.
hackshield.39	Run-time error occurred while updating.
hackshield.40	An error has occurred while updating Hackshield.
hackshield.41	\nPlease take a screenshot and report this to Customer Service.\nError number: {0}
hackshield.42	Warning
hackshield.43	Incorrect data has been sent during authorization.
hackshield.44	Illegal memory access has been detected during authorization.
hackshield.45	Not enough memory.
hackshield.46	An error has occurred with the authorization message.
hackshield.47	A debugger has been detected during authorization.
hackshield.48	An error has occurred with either the routing of the Hackshield Module or the Module itself.
hackshield.49	An error has occurred during authorization.\nPlease take a screenshot and report this to Customer Service.\nError number: {0}
hackshield.50	Warning
hackshield.51	An error has occurred during authorization.\nPlease take a screenshot and report this to Customer Service.\nError number: {0}
hackshield.52	Warning
hackshield.53	Incorrect data has been sent to the Hackshild Module.
hackshield.54	Hackshield Module has yet to be initialized.
hackshield.55	The current process has been loaded in a compatible mode.
hackshield.56	The license key for Hackshield is incorrect.
hackshield.57	A Hackshield file has been corrupted. Please re-install Mabinogi.
hackshield.58	Hackshield is currently running through another program.
hackshield.59	Hackshield has detected a debugger currently running. Please shut down the debugger and restart the game.
hackshield.60	The code for the executing file is modified.
hackshield.61	Only the Administrator may run this.
hackshield.62	Unable to start the Auto-Detect Hax engine for Hackshield.
hackshield.63	Unable to create the driver file for Hackshield.
hackshield.64	Unable to register the driver for Hackshield.
hackshield.65	Unable to start the driver for Hackshield.
hackshield.66	Unable to start the search thread for Hackshield.
hackshield.67	Hackshield Module needs to be updated.
hackshield.68	An error has occurred with Hackshield.
hackshield.69	\nPlease take a screenshot and report this to Customer Service.\nError number: {0}
hackshield.70	Warning
hackshield.71	Unable to read HSUpdate.env.
hackshield.72	Unable to use HSUpdate.env.
hackshield.73	Unable to connect to the update server for Hackshield.
hackshield.74	Unable to find a file for a Hackshield update.
hackshield.75	Runtime error occurred while updating.
hackshield.76	An error has occurred while updating Hackshield.
hackshield.77	\nPlease take a screenshot and report this to Customer Service.\nError number: {0}
hackshield.78	Warning
hackshield.79	Incorrect data has been sent during authorization.
hackshield.80	Illegal memory access has been detected during authorization.
hackshield.81	Not enough memory.
hackshield.82	An error has occurred with the authorization message.
hackshield.83	A debugger has been detected during authorization.
hackshield.84	An error has occurred with either the routing of the Hackshield Module or the Module itself.
hackshield.85	An error has occurred during authorization.\nPlease take a screenshot and report this to Customer Service.\nError number: {0}
hackshield.86	Warning
hackshield.87	We sincerely apologize for this inconvenience, but\n\nan error has been detected with the Hackshield.\n\nError : {0}\nError Code : {1}\n\nThe error code of this error has been saved onto your clipboard.\nPlease search for this code at our website (ctrl+v)\nand find solution to this.\n\nIf no solution was posted on the website, please submit a ticket to Cutomer Support.\n\n\nClick on [OK] to move to the Mabinogi website.\nThe client will be shut down.\n\n
hackshield.88	Hackshield Error
hackshield.89	The system's time functions have been affected by a Speed Hack.
hackshield.90	Unable to start the Hackshield Module.\nPlease re-install the game client.
hsmoduleinit.1	An error has occurred during authorization.
hsmoduleinit.2	Hackshield is currently active and running.
hsmoduleinit.3	A .dll file has been altered.
hsmoduleinit.4	Unable to find HSUpdate.env.
hsmoduleinit.5	Failed to initialize update module for Hackshield.
hsmoduleinit.6	Update address for Hackshield has been forced to switch due to a hosts file.
hsmoduleinit.7	An error has occurred while updating Hackshield. (Error Code : {0})
hsmoduleinit.8	{0} file has been altered.
hsmoduleinit.9	An error has occurred with the update settings file of Hackshield.
hsmoduleinit.10	A problem occurred while launching NexonGuard.
interactionclient.1	Reading the ({0}) interaction...
interactionclient.2	Finished reading the ({0}) interaction.
interactionclient.3	Failed to read the ({0}) interaction, since the data is incorrect. Stopping the interaction.
interactionhelper.1	No name
ladecaconditionhandler.1	Breath of Ladeca
ladecaconditionhandler.2	Vision of Ladeca
ladecaconditionhandler.3	Might of Ladeca
ladecaconditionhandler.4	{0}'s effect will expire in {1} second(s).
mabinogimain.1	보내기
mabinogimain.2	보내기 버튼을 누르시면 개발사에 발생한 문제 상황에 대한 정보가 전달됩니다.
mabinogimain.4	.
mabinogimain.6	[보내기]를 눌러 발생한 문제 상황에 대해 정보를 보내주시면 문제를 해결하는데 큰 도움이 됩니다. 보내시겠습니까? ([보내기]를 눌러 정보를 보내주실 때 이용하신 컴퓨터 사양 정보가 포함될 수 있습니다.)
magicattackenhance.1	The effects from {0:potion} are dissipating.
maintitle.c1	Mabinogi C1
maintitle.c2	Mabinogi C2
maintitle.closebeta	Mabinogi Closed Beta Test
maintitle.default	Mabinogi
maintitle.eg	Mabinogi EG
maintitle.g1	Mabinogi G1
maintitle.g2	Mabinogi G2
maintitle.g3	Mabinogi G3
maintitle.g4	Mabinogi G4
maintitle.openbeta	Mabinogi Open Beta Test
messages.1	Mabinogi G5
messages.2	Mabinogi : Pioneers of Iria
messages.3	PC Spec Auto Diagnosis Service Shortcut
messages.4	OK
messages.5	Cancel
messages.6	Mabinogi : Ancient Secrets of Irinid
messages.7	Mabinogi : Dragon
messages.8	Mabinogi : Alchemist
msg.account_creat_failed	Failed to create a new account.
msg.adv_item.notice_msg	Please click the box on the bottom right corner to receive an Advanced Play item.
msg.agetext_0	Age Limit: {0} - {1}
msg.agetext_1	Age Limit: {0} or Over
msg.agetext_2	Age Limit: Below (0)
msg.arbeit.success_frequency	{0} Part-Time Job     {1} times done, Success Rate {2}%
msg.arbeit_completed	Part-Time Job\n{0} is Complete!\nPlease report to {1}.
msg.arena_logout_safety_notice	Arena logout protection. Protection will end when exiting the Arena.
msg.authorize_failed_use_command	You do not have sufficient rights to use this command.
msg.camp.abandon_cancel_btn	Cancel
msg.camp.abandon_msg	Someone is already inside the camp.\n\nBy deciding to close an occupied camp,\nyou will forfeit the ownership of the camp, and\nit will disappear once everyone inside leaves.\nYou will also no longer be able to revive at this camp.
msg.camp.abandon_ok_btn	OK
msg.camp.abandon_title	Notice
msg.camp.already_have	A camp already exists. Only one camp can be set up at a time.
msg.camp.expired	The item has expired. It can no longer be used.
msg.camp.generate_tooltip	In Use
msg.camp.leave_msg	This camp will disappear once you exit.\nDo you wish to leave the camp?
msg.camp.leave_title	Leave Camp
msg.campsharing_cancel	Cancel
msg.campsharing_info	Food can be shared with those seated around the campfire.\n50% of the food can be shared equally, regardless of the number of people sitting around the fire.\nDo you wish to use Campfire Sharing?
msg.campsharing_info_title	Campfire Sharing
msg.campsharing_message_requiring	You can write a note while sharing food.
msg.campsharing_no	No
msg.campsharing_ok	Yes
msg.cannot_attack	Attack Cancelled
msg.cannot_drop_in_camp	Items cannot be dropped in a camp.
msg.cannot_drop_item	Unable to discard the item!
msg.cannot_use_item	Unable to use the item.
msg.card_help	Use the buttons below to create a new character.
msg.castle_info_not_found	Information on the corresponding house and/or castle cannot be found.
msg.channel_move_desc	Moving to another channel incurs same penalties as re-login.\n\n- Cancel current Part-time job    \n- Teleporting from inside the dungeon to the lobby\n- Automatic drop out from a party               \n-  Logout penalty applied        \n\n
msg.channel_move_notify	If used, you will be moved to {0}. \nTo move to {0}, you will need to use the channel exclusive to {0}.\n\n
msg.character_aging_message	Your character is now {0} years old.
msg.character_explo_levelup_message	Exploration Level Up!\nYou've leveled up to Level {0}!
msg.character_levelup	Level Up!\nYou are now level {0}!
msg.chat_add_friend_failed_cannot_find	User {0} cannot be found. \nOnly users that have logged on at least once after the Messenger system was implemented can be added as friends.
msg.chat_add_friend_failed_full	Your character(s) {0}\nalready have more than {1} friends in the messenger, so\nno more friends can be added.
msg.chat_add_friend_failed_logout	Friends can only be added when logged into the Messenger.
msg.chat_add_self	You cannot add yourself.
msg.chat_ban_failed_cannot_find	User {0} cannot be found.
msg.chat_ban_failed_logout	You need to log in to block a user.
msg.chat_ban_self	You cannot block yourself.
msg.chat_closing_window_by_logout	This window can no longer be used since you have logged out.
msg.chat_confirm_friend_failed_full	Your character(s) {0} \nalready possess more than {1} friends, and therefore, no more friends can be added. \nPlease log in again after deleting 1 or more friends from the above character(s).
msg.chat_connection_closed_etc	Connection to the server lost. Automatic re-login will begin.
msg.chat_connection_closed_etc.development	Connection to the chat server lost for an unknown reason.
msg.chat_friend_deleted	Your friend's character {0} was deleted. All related information has been erased.
msg.chat_friend_state_changed	{0}'s status has changed to {1}.
msg.chat_id_password_mismatch	Failed to connect to the Messenger. Will retry connection on the next log in.
msg.chat_id_password_mismatch.development	Incorrect user name or password. Please try again.
msg.chat_invalid_charactername	Character name is invalid. Please submit a ticket to Customer Support about this character/server.
msg.chat_login_from_othersite	You have logged in from another location. Automatic log in will start in a few moments.
msg.chat_login_from_othersite.development	You have logged in from another computer, causing the current connection to end.
msg.chat_sendmessage_failed	Failed to send the following message.
msg.chat_server_connection_failed	Failed to connect to the communication server. Auto re-login will begin in a few moments.
msg.chat_server_connection_failed.development	Failed to connect to the Chat Server. Please try again later.
msg.chat_server_unavailable	No communication server currently available. Automatic retry will start in a few moments.
msg.chat_server_unavailable.development	Chat server is currently unavailable. Please try again later.
msg.chat_someone_added_me	Your friend has notified you about a new character. \nThe following characters will be seen as one. \n\n{0}
msg.chat_unable_while_offline	You cannot open a chat window while in the Appear Offline state.
msg.chat_unban_failed_logout	You need to log in to unblock a blocked user.
msg.collect_reward_failed	You were unable to receive any rewards.
msg.collectionbook.already_rewarded	You have already received a reward.
msg.collectionbook.complete_rate	{0}% completed
msg.collectionbook.rewardable	The reward can be collected.
msg.combat.weapon_weaker_than_barehand	Better to fight with bare hands rather than with {0}.|{0} is useless as a weapon. Bare hands would be better. |Fighting with bare hands would be better than with the {0}.|The attack rate of the {0} is even lower than fighting with bare hands!
msg.confirm_use_coupon	Do you wish to use this coupon and receive the reward?
msg.connect_failed_to_localserver	Failed to connect to the local server.
msg.create_char_fail_max	Failed to create a new character.\n\n* Only up to 20 characters can be created per account.
msg.create_character_fail_max_80	Failed to create a new character.\n\n*You can create a maximum of 80 characters.
msg.create_dungeon_time	Situation has arisen at present time {0}, {1} {2} {3}:{4}
msg.create_pet_fail_max	Failed to create a new Animal Character\n\n*You may create only up to 20 animal characters.
msg.critical_hit	Critical Hit!!!
msg.critical_hit_msg	Critical Hit!!!
msg.cutscene_leader_skips_demo	Your party leader has skipped the clip.
msg.cutscene_wait	Please wait for a moment...
msg.cutscene_wait_for_leader	Your party leader is still watching the clip.
msg.destroy_item_confirm	Do you really want to destroy {0}?
msg.dev.bank_not_savable	Deposit not allowed
msg.dev.bank_not_sharable	Bank sharing not allowed
msg.dev.is_proxy	Proxy
msg.dev.keep_owner	Retain ownership
msg.dev.not_destructable	Indestructible
msg.dev.not_enchantable	Not enchantable
msg.dev.not_removable	Not removable
msg.dev.not_repairable	Not repairable
msg.dev.not_tradable	Not tradable
msg.dev.region_fixed	Fix Region
msg.dungeon_create_waiters	Waiting for a dungeon to be created. {0} players to go...
msg.dungeon_logout_safety_notice	Dungeon logout protection. It will end when exiting the dungeon.
msg.dungeon_pass_tooltip	\nExpires in {0}
msg.dungeon_pass_tooltip_expire	Time Expired
msg.ego_talk_equip	Please equip the Spirit Weapon in order to talk with the spirit.
msg.enchant.scroll_only_warning	If you use an Enchant Scroll without knowledge of the Enchant skill, the scroll will be consumed, regardless of the result.\n\nContinue?
msg.enchant.scroll_only_warning_title	Notice
msg.enchant_bad	Enchantment failed!
msg.enchant_best	Enchantment was a great success!!!
msg.enchant_good	Enchantment was a success!
msg.enchant_scroll_expired_prefix	Time Expired
msg.enchant_scroll_expired_suffix	Time Expired
msg.enchant_scroll_expiretime_prefix	\nExpires in {0}
msg.enchant_scroll_expiretime_suffix	\nExpires in {0}
msg.enchant_scroll_prefix	Prefix
msg.enchant_scroll_suffix	Suffix
msg.enchant_worst	Enchantment was a huge failure!!!
msg.engine_initializing	Initializing Pleione Engine...
msg.enter_world	You have entered the world of Mabinogi.
msg.equip_ego_weapon_request	Please equip the Spirit Weapon in order to talk with the spirit.
msg.error.1	The game cannot run because the graphic card was not initialized correctly.\n\nIf the issue continues when using nVidia series cards,\ninstall the latest graphic card driver available and try again.\nPlease submit a ticket to Customer Support for further details.\n\n
msg.error.2	The graphic card installed on your system\ndoes not support critical functions required to run the game.\nThe program will no longer proceed.
msg.error.3	Sorry for the inconvenience.
msg.error.4	DirectX 9.00 or higher is required to run the Mabinogi client.\nDownload and install the latest DirectX version and try again.
msg.error.5	Sorry for the inconvenience.\n\nThe problem description for the occurring issue has been copied to the clipboard.\nPlease submit a ticket to Customer Support\nso that it may be referenced during bug resolution.\n\nIf you post the message using the Mabinogi Error Assistant\nit will greatly help us check and resolve the issue. \nPress OK to return to the Bug Report Board.\nYou will be logged off from the game.\n
msg.error.6	Mabinogi: An error occurred during execution.
msg.error.7	Mabinogi
msg.error.8	Bug Report
msg.error.9	Compatibility mode activation is not necessary,\nbecause Mabinogi supports the latest Windows versions.\nIf you wish to use all your Windows functions without restriction, we recommend you disable Compatibility mode.\n\nDo you wish to disable Compatibility mode?
msg.error.10	Attention!
msg.error.11	Please run again after disabling Compatibility mode.
msg.error.12	Mabinogi
msg.error.13	Compatibility mode has been disabled.\nPlease run Mabinogi again.
msg.error.14	Another Mabinogi client is already running.
msg.error.15	The graphic card installed on your system\ndoes not ensure proper execution of the Mabinogi client.\nThis graphic card does not support a minimum number of key requirements.\nRunning the client with this card may cause unexpected issues,\nincluding the unstable execution of the Mabinogi client.\n\nDo you wish to continue?\n
msg.error.16	http://www.mabinogi.com/4th/3_free.asp?bc=4
msg.fix_charge_10x	Repair Fee x10
msg.gdi_startup	Preparing to run
msg.gift_help	Click See to receive the present.
msg.gm.confirm_force_open_door	Do you wish to open this door?
msg.gm.not_move_silencemode	Moving with Mute Mode enabled is not recommended.
msg.guild_create.agreed	{0} has agreed on forming a Guild.
msg.guild_create.agreement_request	Do you agree with {0}, the party leader, on forming a guild called {1}?
msg.guild_create.agreement_request_title	Agree to Guild Formation
msg.guild_create.already_guildmember	You are currently a guild member.
msg.guild_create.confirm_create	All party members have agreed on forming a guild. Do you wish to form one?
msg.guild_create.confirm_create_title	Confirm Guild Formation
msg.guild_create.create_request	You have successfully submitted a request to form a new guild. Please wait until all party members agree to the guild creation.\nIf failed, you'll need to create a new party in order to re-apply for one.
msg.guild_create.create_request_failed	The request to form a new guild has failed.\nCreate a new party and try again.
msg.guild_create.daylimit	{0} cannot join the guild. A week must pass before joining another guild.
msg.guild_create.disagreed	{0} has not agreed on forming a new guild.
msg.guild_create.insufficient_member	You must be the leader of a party of 5 to form a guild.
msg.guild_create.no_pet	Unable to create a guild due to one of the party members being an animal character.
msg.guild_distroy	The guild will be disbanded.\nIt may take about 1 minute to complete the process.
msg.guild_distroy_failure	Failed to disband the guild.
msg.guild_failure	Fail
msg.guild_join_awaiting_notice	Application has been submitted.\nThe Guild Leader will need to approve your application to become a guild member.
msg.guild_name_usable_failure	This name is not available.\nTry another name.
msg.guild_name_usable_success	This name is available.
msg.guild_success	Success
msg.guild_transition_master	The Guild Leader has been successfully changed.\nIt may take about 1 minute to complete the change.
msg.guildchat_logout_or_invalid	You are either not logged into the messenger, or the guild is not valid.
msg.guildchat_unavaiable_notice	We are sorry, but guild chat is currently unavailable.
msg.house_prop_confirm	You must pay a fee of {0} Gold to use this.\nAre you sure you want to use it?
msg.house_prop_unavailable	This is currently not availble for use.\nPlease contact the current tenant.
msg.immune_magic_rate	<color=3>Auto Defense (Magic): {0}%</color>
msg.immune_melee_rate	<color=3>Auto Defense (Melee): {0}%</color>
msg.immune_ranged_rate	<color=3>Auto Defense (Ranged): {0}%</color>
msg.inventory_cannot_throw_pocket_containing	A bag containing items inside cannot be discarded.
msg.inventory_cannot_use_bag	Extra Storage is required to open the bag.\nPlease use 'Empty Bag' command to retrieve the items in the bag.
msg.ipservice_timeout_notice	프리미엄 PC 방 서비스 시간이 만료되었습니다.
msg.item.directbank_tradable	Direct Bank Transaction enabled
msg.item.directbank_untradable	Direct Bank Transaction disabled
msg.item.durability	Usage Count {0}/{1}
msg.item.skill_restriction	Skill Restriction: {0} Rank {1} or higher
msg.item_attack	Attack {0}-{1}
msg.item_attackspeed_fast	Fast
msg.item_attackspeed_normal	Normal
msg.item_attackspeed_slow	Slow
msg.item_attackspeed_veryfast	Very Fast
msg.item_attackspeed_veryslow	Very Slow
msg.item_burnup_failed	Failed to burn the item.
msg.item_buy_failed	You cannot buy this item.
msg.item_check_description	Please pay the amount listed below to the item holder.
msg.item_check_tooltip	{0} Gold
msg.item_coupon_reward_tooltip	The reward for this coupon
msg.item_critical	Critical {0}%
msg.item_defense	Defense {0}
msg.item_drop_failed	You cannot drop this item.
msg.item_durability	Durability {0}/{1}
msg.item_durability_current	Use Count {0}/{1}
msg.item_exp	Proficiency {0} ({1}%)
msg.item_exploquest	Exploration Quest
msg.item_give_failed	This item cannot be gifted.
msg.item_give_failed_not_givable_item	This item cannot be given to someone else.
msg.item_give_failed_toofar	Unable to gift this item due to the target being too far away.
msg.item_guildpendant_bind	\n\n<color=1> You are currently bound to  <color=2>{0}<color=1>guild.
msg.item_maker_blacksmith	Blacksmith
msg.item_maker_cloth	Tailor
msg.item_maker_default	Crafter
msg.item_maker_desc	{1:jobclass} {0:rank} {2:name}'s work
msg.item_maker_heulwenengineering	Hillwen Engineer
msg.item_maker_magiccraft	Magic Crafter
msg.item_nogive_property	This item cannot be given to someone else.
msg.item_original	(Original)
msg.item_pickup_failed_general	You cannot pick up this item.
msg.item_pickup_failed_invalid_item	The item does not exist.
msg.item_pickup_failed_inventory_insertion_failed	You cannot add this item to your inventory.
msg.item_pickup_failed_no_authority	I do not have the right to pick up this item.|This item is not for me.|I cannot pick up this item.|I cannot pick up someone else's item.
msg.item_pickup_failed_no_authority2	This item is not for me. |I can't pick up this item. | This item belongs to someone else and therefore I cannot pick it up.
msg.item_pickup_failed_notenough_space	There is not enough space in your inventory.
msg.item_pickup_faled_unique	You can have only one of this item.
msg.item_protect	Protection {0}
msg.item_remove_failed	You cannot destroy this item.
msg.item_reversion	{0}-only Item
msg.item_sell_failed	You cannot sell this item.
msg.item_size_desc	\n\nSize: {0} cm
msg.item_skill_limit	Skill Limit: {0} Rank {1} or higher
msg.item_skill_restrict	This item can only be equipped by characters with at least Rank {1} in {0}.
msg.item_tooltip.exploquest	Exploration Quest
msg.item_tooltip.general_prop_sketched	Sketched
msg.item_tooltip.keyexploquest	Mandatory Exploration Quest
msg.item_tooltip.monster_sketched	A sketch of {0} 
msg.item_tooltip.prop_sketched	A sketch of {0} 
msg.item_tooltip.require_explolevel	Exploration Level: {0}
msg.item_tooltip.time_remaining	Time remaining : {0} min.
msg.item_upgrade	Modify Count {0} / Available Modify Count {1}
msg.item_upgraded	Upgraded {0} with {1}.
msg.item_valance	Balance {0}%
msg.item_weapontype_hitcount	{0} {1} Hit Weapon
msg.item_weapontype_ranged	{0} Ranged Weapon
msg.item_wounddamage	Injury Rate {0}-{1}%
msg.license.cumulated_gold	Total Amount: {0} Gold
msg.license.deposit_commission	Exchange Fee {0}%
msg.license.gold_limit	Limits {0} Gold
msg.license.not_usable	Unusable
msg.license.sell_commission	Sales Fee {0}%
msg.license.selling_price	Sales Amount: {0} Gold
msg.license.unusable_area	Unusable Area
msg.license.usable_area	Usable Area
msg.lobby_cancel_character_delete_failed	Failed to restore the character.
msg.lobby_cardtype_discount	(Discount card)
msg.lobby_cardtype_prize	(Product card)
msg.lobby_cardtype_test	(Test card)
msg.lobby_character_create_failed	Failed to create a new character.\n\nThe name may already have been taken by another player.\nPlease select another name and try again.
msg.lobby_character_create_failed_age	Failed to create a new character.\n\n* Your age does not comply with the server requirements.\n* Please read the description of each server and select again.
msg.lobby_character_create_failed_card_condition	Failed to create a new character.\n\n* You have selected an appearance not supported by your present creation card.
msg.lobby_character_create_failed_card_error	Failed to create a new character.\n\n* The information in the character card is invalid.\n* Please submit a ticket to Customer Support for further details.
msg.lobby_character_create_failed_internal_error	Failed to create a new character.\n\n* An internal error occurred while creating the character.\n* Please take a screenshot of the current screen and submit a ticket to Customer Support.
msg.lobby_character_create_failed_old	Failed to create a new character.\n\nThe name may already be in use by another player.\nPlease select another name and try again.
msg.lobby_character_create_failed_same_name	Failed to create a new character.\n\n* The name may already be in use by another player or it may not be available in the game.\n* Please try using another name.
msg.lobby_character_create_failed_too_many	Failed to create a new character.\n\n* You have a total of 20 characters and pets.
msg.lobby_character_create_failed_unknown_error	Failed to create a new character.\n\n* An internal error ({0}) occurred while creating the character.\n* Please take a screenshot of the current screen and submit a ticket to Customer Support.
msg.lobby_character_delete_failed	Failed to delete the character.
msg.lobby_character_delete_failed2	Failed to delete the character.
msg.lobby_charactercard	<Character card>
msg.lobby_charactercard_basic	<베이직카드>
msg.lobby_charactercard_basic_discount	<베이직카드 (할인)>
msg.lobby_charactercard_basic_promotion	<베이직카드 (상품)>
msg.lobby_charactercard_basic_testserveronly	<베이직카드 (테스트서버)>
msg.lobby_charactercard_event	<이벤트 환생카드>
msg.lobby_charactercard_event_rebirth	Free character creating card
msg.lobby_charactercard_free	<Free card>
msg.lobby_charactercard_premium	<프리미엄 카드>
msg.lobby_charactercard_premium_2005_summer	<프리미엄 한정 카드>\n2005년 여름 한정 품목
msg.lobby_charactercard_premium_2005_summer_discount	<프리미엄 한정 카드 (할인)>\n2005년 여름 한정 품목
msg.lobby_charactercard_premium_2005_summer_discount_reduced	<프리미엄 한정 카드 (할인)>
msg.lobby_charactercard_premium_2005_summer_reduced	<프리미엄 한정 카드>
msg.lobby_charactercard_premium_2005_winter	<프리미엄 한정 카드>\n2005년 겨울 한정 품목
msg.lobby_charactercard_premium_2005_winter_discount	<프리미엄 한정 카드 (할인)>\n2005년 겨울 한정 품목
msg.lobby_charactercard_premium_2005_winter_discount_reduced	<프리미엄 한정 카드 (할인)>
msg.lobby_charactercard_premium_2005_winter_reduced	<프리미엄 한정 카드>
msg.lobby_charactercard_premium_discount	<프리미엄 카드 (할인)>
msg.lobby_charactercard_premium_promotion	<프리미엄 카드 (상품)>
msg.lobby_gift_type	Gift from {0}
msg.lobby_local_duplicated	This name is already taken by someone else.
msg.lobby_name_available	"{0}"\nThis name is available
msg.lobby_name_not_available	"{0}"\nThis name is not available.
msg.lobby_notice	Notice
msg.lobby_petcard	<Animal Character Card>
msg.lobby_petcard_race	<'{0}' card>
msg.lobby_read_character	Reading character information.
msg.lobby_read_character_fromcard	Reading character information.
msg.lobby_read_character_old	Reading character information.
msg.login.blocked	This account has been banned for another {0}hr(s) {1}min(s).
msg.login.booting	Login Server is currently under maintenance.\nPlease log in again later.
msg.login.char_invalid	An unexpected error has occurred to the character data. \nIt might take some time to restore the character information.
msg.login.inf_blocked	This account has been banned. \nIf you wish to appeal the ban, please submit a ticket to Customer Support through the Mabinogi website. \nPlease select "Game Related" as the category and "Ban or Suspension Appeals" as the sub-category.
msg.login.internal_error	An error has occurred to the corresponding account.
msg.login.ip_blocked	You cannot log into the game from your current location.
msg.login.lack_age	We are sorry, but you cannot log in with an account if you are below 12 years old.
msg.login.unblocked	The suspended account has been reactivated.
msg.login_delay_dialog_msg	Your connection was terminated abnormally. Please wait 30 seconds before you attempt to log in again.
msg.login_delay_dialog_ok	OK
msg.login_delay_dialog_title	Message
msg.login_failed_general	Failed to log in.
msg.login_failed_id_password_mismatch	Your account name or password is invalid.\n\nPlease check to see if you have the Caps Lock key on or if you have misspelled your information.
msg.login_failed_server_full	Unable to connect to the server due to too many users.
msg.moonstone_tooltip	<color=0>Use a piece of Moon Stone to\ntransport yourself to the spot where you'd first found it.\nTransporting to : [<color=3>{0}<color=0>]
msg.move_channel_failed	Failed to change channels.
msg.nao_support.recharged	You have earned an additional "Nao's Support".
msg.no_collect_invalid_item	Unable to add item.
msg.no_collect_not_completed	Incomplete items cannot be stored.
msg.no_collect_target_item	Not a collectable item.
msg.no_title	No Title
msg.none_attackable_target	Not an attackable target.
msg.noskill_available_touse_thisprop	You do not have the skill to use this equipment.
msg.noskill_available_touse_thisprop2	This device cannot be used.
msg.notice_pause_auto_combat	Now temporarily disabling Auto Combat.
msg.order_scroll_expired	The time stated in the scroll has passed.
msg.order_scroll_tooltip	This Command Scroll says that {2} will appear at {0} in {1}.
msg.party_expmode_changed	{0} has changed the party's EXP distribution rules to [{1}].
msg.party_finishrule_changed	{0} has changed the party's finish rules to [{1}].
msg.party_join_failed_invalid_password	Incorrect password. You cannot join this party.
msg.party_kicked	You have been removed from the party.
msg.party_leader_changed	{0} has become the party leader.
msg.party_member_out	{0} has left the party.
msg.party_newmember	{0} has joined the party.
msg.party_newmember2	{0} has joined the party.
msg.party_newmember3	{0} has joined the party.
msg.party_out	You have left the party.
msg.party_quest_changed	{0} has changed the party quest to [{1}].
msg.party_quest_removed	{0} has removed the party quest.
msg.party_start_recruiting	Start party recruitment.
msg.party_stop_recruiting	Stop party recruitment.
msg.pet.ai_on	You have ordered your pet to attack at will.
msg.pet.confirm_give_item	Would you like to feed your pet with {0}?
msg.pet.favor_status	Closeness : {0}
msg.pet.food_status	Hunger : {0}
msg.pet.have_not_revive	{0} does not have a Rescue Kit.
msg.pet.healing_ai_on	You have ordered your pet to use Heal during the battle.
msg.pet.idle_msg	I should just let it do whatever it wants...|Should I just leave it alone...|Should I let it rest...?
msg.pet.idle_off	Let's get moving!|Let's go!|Wake up!
msg.pet.in_summon	Summoning...
msg.pet.in_unsummoning	Cancelling the summoning...
msg.pet.life_status	HP : {0}%
msg.pet.loyalty_status	Loyalty Level : {0}
msg.pet.meet_mate_control	You are now dating {0}.
msg.pet.meet_mate_summon	{0} and {1} have become a couple.
msg.pet.not_collect_pet	This pet cannot gather items.
msg.pet.not_collect_pet2	This pet cannot gather items.
msg.pet.pickup_ai_on	The pet starts to pick up items.
msg.pet.pickup_fail_put	{0}'s inventory is full.
msg.pet.pickup_gold	{0} has picked up {1} Gold.
msg.pet.pickup_inventory_full	{0}'s inventory is full.
msg.pet.pickup_item_bundle	{0} has picked up {2} {1}s.
msg.pet.pickup_item_single	{0} has picked up {1}.
msg.pet.remain_time	Time remaining : {0} min.
msg.pet.separate_mate_control	You have ended the relationship.
msg.pet.separate_mate_summon	{0} has ended the relationship.
msg.pet.start_other_collect	Allow others to gather from the pet.
msg.pet.started_attack	{0} has started attacking {1}.
msg.pet.started_keeper	{0} has started to protect the Personal Shop.
msg.pet.status_dead	{0} is unconscious.
msg.pet.status_hunger1	{0} seems to be very hungry.
msg.pet.status_hunger2	{0} seems to be hungry.
msg.pet.status_hunger3	{0} seems to be just a bit hungry.
msg.pet.status_hunger4	{0} seems to be full.
msg.pet.status_hunger5	{0} seems to be very much full.
msg.pet.status_life1	{} became unconscious.
msg.pet.status_life2	{0} seems to be in need of immediate help.
msg.pet.status_life3	{0} seems to be in need of care.
msg.pet.status_life4	{0} seems to be a little sick.
msg.pet.status_life5	{0} seems to be healthy.
msg.pet.status_life6	{0} seems to be very healthy.
msg.pet.stop_other_collect	Don't let others gather from this pet.
msg.pet.stopped_keeper	{0} has stopped protecting the Personal Shop
msg.pet.summon_status_title	Message
msg.pet.summon_timeout_warning	{0}'s summoning time has {1} min. left
msg.pet.summoned_msg	You have summoned {0}.
msg.pet.support_ai_on	You have ordered to help out during battles.
msg.pet.time_limit	You have used up all the summoning time of {0}.
msg.pet.time_remain_msg	{0}'s summoning time has {1} min. left
msg.pet.unable_give_item	Unable to give {0}
msg.pet_pvp.begin	The battle will now begin!
msg.pet_pvp.loser	{0} lost in the battle.
msg.pet_pvp.loser_desc	{0} has lost the battle.
msg.pet_pvp.start	The battle will now begin!
msg.pet_pvp.winner	{0} has won the battle!
msg.pet_pvp.winner_desc	{0} has won the battle!
msg.pet_timeout_unsummon	The summoning will be canceled due to lack of remaining summon time.
msg.petcard_help	To create a new pet, click 'New Pet',\nand to have your animal character go through rebirth, click 'Rebirth'.
msg.playtime_almost_out_notice	Today's allowed playing time is almost over.
msg.playtime_out_notice	Today's allowed play time is over.
msg.ps_shop.opened	A shop has been created.\nBeware that if you are more than 5 yards away, the shop will close.\nIf you wish to venture out while keeping it open, summon a pet to guard the shop.
msg.ps_shop.opened2	A shop has been created.\nBeware that if you are more than 5 yards away, the shop will close.\nIf you wish to venture out while keeping it open, summon a pet or Brownie to guard the shop.
msg.ps_shop.set_title	Enter the name of your Personal Shop.
msg.ps_shop.set_value	Please set the prices for items.
msg.ps_shop.unable_pet	Animal characters cannot open Personal Shop.
msg.pvp_arena_life_recovered	{0} {1} Recovery
msg.pvp_arena_mana_recoverd	{0} {1} Recovery
msg.pvp_arena_round_end_alive	The round has ended.
msg.pvp_arena_round_end_died	The round has ended.
msg.pvp_arena_stamina_recovered	{0} {1} Recovery
msg.pvp_arena_wound_recovered	Wound {0} Recovery
msg.quest_almost_expired	Time limit is almost over.
msg.quest_complete	[X]
msg.quest_complete2	[X]
msg.quest_complete_scroll	Complete
msg.quest_completed	Homework\n{0} is Complete!\nPlease report to {1}.
msg.quest_expired	Expired
msg.quest_expired2	Expired
msg.quest_expired_already	Expired
msg.quest_objective_completed	Quest objectives for\n{0} complete.
msg.quest_received	Quest received: {0}
msg.quest_remain_time_day	Complete in {0} day(s)
msg.quest_remain_time_day_hour	Complete in {0} day(s), {1} hour(s)
msg.quest_remain_time_hour	Complete in {0} hour(s)
msg.quest_remove_scroll	Delete Mission
msg.quest_scroll_result	Mission Reward
msg.quest_scroll_time_day	Complete within {0} day(s)
msg.quest_scroll_time_day_hour	Complete within {0} day(s), {1} hour(s)
msg.quest_scroll_time_expiretime	Time Limit:
msg.quest_scroll_time_hour	Complete wihin {0} hour(s)
msg.quest_scroll_time_veryshort	Very Short
msg.remain_playtime_notice_hour	Remaining play time for today is {0} hour(s).
msg.remain_playtime_notice_hour_minute	Remaining play time for today is {0} hour(s), {1} minute(s).
msg.remain_playtime_notice_minute	Remaining play time for today is {0} minute(s).
msg.score_composer	Composer: {0}
msg.score_level	Difficulty:
msg.score_level_other	Grade {0}
msg.score_level_training	Drawing
msg.score_title	Name: {0}
msg.scroll_durability	Durability {0}%
msg.scroll_remain_uses	Remaining Use Count {0}
msg.server_select_failed_no_authority	You do not have access rights to the selected server.
msg.service_expire_bag	Your Extra Storage session has expired, and all your open bags have been locked.\nPlease use 'Empty Bag' command to retrieve the items in the bag.
msg.shutdown_alarm	You will logout automatically after {0} second(s).
msg.shutdown_alarm_title	Notice
msg.skill.another_skill_using	Another skill is already in use.
msg.skill_insufficent_ability_info	* You do not have enough AP (Ability Points) to level up. *\n\nAP is obtained when a character levels up.\nA character's EXP increases automatically when you train each skill, \nso AP can be obtained by training other skills or through quests.\nYou also get AP when a character gets 1 year older,\nso spending time is also a good way.\nRequired AP: {0} AP\nCurrent AP: {1} AP
msg.skill_know	You have gained knowledge about the {0} skill.
msg.stone	You have been petrified.
msg.stone_release	You have snapped out of petrification.
msg.stone_skill	You have been temporarily petrified.
msg.stone_skill_end	You have been unpetrified.
msg.title_add	You have acquired the '{0}' title.
msg.title_know	You have gained knowledge about the '{0}' title.
msg.title_removed	Title has been removed.
msg.title_use	Now using '{0}' title.
msg.toofar_to_talk	You are too far away to hold a decent conversation.
msg.tooltip.house_bidding	Accepting Bids
msg.tooltip.house_empty	Empty Shop
msg.tooltip.house_owner	{0}'s Shop
msg.tooltip.item_repair_cost_down	Repair fee - {0}%
msg.tooltip.item_repair_cost_up	Repair fee + {0}%
msg.tooltip.no_enchant_level_limit	Enchant available regardless of the rank limit
msg.tooltip.poison_durability	Poison Durability : {0}%
msg.tooltip.poison_immune	Poison Immunity : {0}%
msg.tooltip.posion_attackrate	Poison Attack : {0}%
msg.tooltip.wedding	{0} and {1}'s Wedding
msg.trade_canceled	Trade has been canceled.
msg.trade_success	Trade was successful.
msg.ui_load_failed	Failed to load the user interface.
msg.ui_loading	Loading user interface.
msg.upgrade	Upgrade {0}/{1}
msg.use_item.need_skill	You need to be able to use {1} skill in order to use {0}.
msg.use_item.pet_cannot_use_agepotion	This item is not available to animal characters.
msg.use_item.title_use_agepotion	Notice
msg.use_item.use_agepotion_msg	Your character will grow a year older if you use an aging potion.\nDo you want to use it?
msg.use_item_riding_fail	This item cannot be used at this time.
msg.valentine_cancel	Cancel
msg.valentine_info	On Valentine's Day, you can send a piece of your heart by giving chocolate to your loved one.\nWould you like to use the chocolate delivery service?\n(If you just want to eat the chocolate, select 'No')
msg.valentine_info_title	Send Chocolate
msg.valentine_no	No
msg.valentine_ok	Yes
msg.valentine_receiver_requiring	Enter the recipient's name and a message
msg.warn_unable_untrain_skill	This skill cannot be untrained.\nDo you wish to level this skill up?
msg.warp_moonstone_tooltip	<color=0>Use a piece of Moon Stone to\ntransport yourself to the spot where you'd first found it. \nTransporting to : [<color=3>{0}<color=0>]
msg.warp_scroll_tooltip	<color=0>Using this item will teleport you to the designated location.\nDestination: [<color=3>{0}<color=0>]
msg.whiteday_info	On Valentine's Day, you can send a piece of your heart by giving chocolate to your loved one.\nWould you like to use the chocolate delivery service?\n(If you just want to eat the chocolate, select 'No')
msg.whiteday_info_title	Send Chocolate\n
msg.xmas_info	On Christmas Day, it is customary to show people you care about them by sending Holiday Cakes.\nWould you like to use the Holiday Cake delivery service?\n(If you would rather just eat it yourself, select 'No'.)
msg.xmas_info_title	Send Cake
ngs.1	NGS Error
ngs.2	Please take a screenshot of this error message.\n\nThen locate the BlackCipher folder for Mabinogi. The default location can be found below:\nDirect Launch: C:\Nexon\Mabinogi\BlackCipher\nNexon Launcher: C:\Nexon\Library\mabinogi\appdata\BlackCipher\nSteam: C:\Program Files\Steam\steamapps\common\Mabinogi\BlackCipher\n\nVisit the Support Section of the Mabinogi website and “Submit your Request”. You may use the “Technical Support” and “Crash” selections. Attach all files located in your BlackCipher folder and the screenshot to your request ticket.
oasischatsystem.1	You have ordered the pet to wait for command during battle.
oasisrulesystem.1	Using \"{0}\" from the Pet AI.
oasisrulesystem.2	Failed to use \"{0}\" from the Pet AI.
oasisrulesystem.3	Failed to use \"{0}\" from the Pet AI.
oasisrulesystem.4	Using \"{0}\" from the Pet AI.
partyexpbuff.1	Party Buff has been activated.\nAll party members receive Combat EXP +{0}%.
partyexpbuff.2	Party Buff has been deactivated.
pleione.4	\\Mabinogi\\Pet AI
pleione.5	\\Mabinogi\\Settings
pleione.6	\\Mabinogi\\Video
pleione.7	\\Mabinogi\\Visual Chat
pleione.8	\\Mabinogi\\Interaction
pleioneaccount.0	{0}시간이 경과했습니다. 잠시 쉬었다 하시기 바랍니다.
pleioneaccount.1	{0}시간이 경과했습니다
pleioneaccount.2	건전한 인터넷문화 정착을 위해 넥슨 회원가입시 반드시 본인의 주민등록번호를 입력해주세요.
pleioneaccount.3	본 게임은 12세 이용가입니다.
pleioneaccount.4	안전한 계정관리를 위해 주기적으로 게임 비밀번호를 변경하시기 바랍니다.
pleioneaccount.5	Please do not share your personal information with others, including your ID and PW. 
pleioneaccountmsg.1	Another animal has already been summoned.
pleioneaccountmsg.2	Your Mabinogi Premium Service runs out in {0} hour(s) and {1} minute(s).
pleioneaccountmsg.3	Your Mabinogi Premium Service runs out in {0} hour(s).
pleioneaccountmsg.4	Your Mabinogi Premium Service runs out in {0} minute(s).
pleioneaccountmsg.5	Your Mabinogi Premium Service is about to expire.
pleioneaccountmsg.6	Your Mabinogi Premium Service has expired.
pleioneaccountmsg.7	You don't have enough Pon.\nYou will need to buy more.
pleioneaccountmsg.8	You've made a purchase. \nYou have {0} Pon remaining.
pleioneaccountmsg.9	{0} : 시설물을 설치하는 데 {1}폰이 사용되었습니다.
pleioneaccountmsg.10	{0}: {1} Pon used in the construction of buildings.
pleioneaccountmsg.11	{0}: {1} Pon needed to set up the structure.\n{2} Pon left.
pleioneaccountmsg.12	마비노기 프리미엄 플러스 팩 이용이 {0}시간 {1}분 남았습니다
pleioneaccountmsg.13	마비노기 프리미엄 플러스 팩 이용이 {0}시간 남았습니다
pleioneaccountmsg.14	마비노기 프리미엄 플러스 팩 이용이 {0}분 남았습니다
pleioneaccountmsg.15	마비노기 프리미엄 플러스 팩 이용이 잠시 후에 종료됩니다
pleioneaccountmsg.16	마비노기 프리미엄 플러스 팩 이용이 종료되었습니다
pleioneaccountmsg.17	You obtained {0} Pon.\n{1} Pon remain.
pleioneaccountmsg.18	You spent {0} Pon.\n{1} Pon remain.
pleionechina2018authsystem.3	청소년 건강 보호를 위해 해당 시간에는 접속이 불가능 합니다.
pleionecontrollercharactercmd.1	Would you like to give the performer an item?
pleionecontrollercharactercmd.2	The animal character is not present.
pleionecontrollercharactercmd.3	It seems too small for me.
pleionecontrollercharactercmd.4	The sled might break if you ride it here.
pleionecontrollercharactercmd.5	You can't ride the sled because there are obstacles near your pet.
pleionecontrollercharactercmd.6	You can't use this skill right now.
pleionecontrollercharactercmd.7	I can’t use a paddle outside the raft.
pleionecontrollercharactercmd.8	I can’t use a paddle that belongs to a different raft.
pleionecontrollercharactercmd.9	Do you wish to dismount from the hot air balloon?
pleionecontrollercharactercmd.10	Do you wish to dismount from the hot air balloon?
pleionecontrollercharactercmd.11	You cannot mount a character while it is gesturing.
pleionecontrollercharactercmd.12	You can't use another skill while preparing for the Final Shot.
pleionecontrollercharactercmd.13	You can only use long range attacks while using Final Shot.
pleionecontrollercharactercmd.14	You can't use another skill while preparing for the Wind Guard.
pleionecontrollercharactercmd.15	You can only use Taunt while Wind Guard is activated.
pleionecontrollercharactercmd.16	Cannot mount on its head while unconscious.
pleionecontrollercharactercmd.17	You can only use Taunt and Windmill while Wind Guard is activated.
pleionecontrollercharactercmd.18	Average Firewood
pleionecontrollercharactercmd.19	Fine Firewood
pleionecontrollercharactercmd.20	Finest Firewood
pleionecontrollercharactercmd.21	Firewood
pleionecontrollercharactercmd.22	Do you wish to use the campfire made with {0}\nto burn the {1}?\nYou'll be able to obtain a small amount of EXP and an Enchant Scroll or Magic Powder as a reward.
pleionecontrollercharactercmd.23	Do you wish to use the campfire made with {0}\nto burn the {1}?\nYou'll be able to obtain a small amount of EXP and an item as a reward.\n In order to extract an Enchant, you'll need a Mana Herb and a Holy Water of Lymilark.
pleionecontrollercharactercmd.24	Do you wish to use the campfire made with {0}\nto burn the {1}?\nYou'll be able to obtain a small amount of EXP and an item as a reward.
pleionecontrollercharactercmd.25	Do you wish to use the campfire made with {0}\nto burn the {1}?\nYou'll be able to obtain a small amount of EXP and an item as a reward.\n In order to extract an Enchant, you'll need a Mana Herb and a Holy Water of Lymilark.
pleionecontrollercharactercmd.26	This item cannot be picked up again. Would you like to continue?
pleionecontrollercharactercmd.27	You cannot engage in combat while carrying Trade Goods.\nPress the <hotkey name=\"Riding\"/> key to set down your Trade Goods before engaging in combat.
pleionecontrollercharactercmd.28	Notice
pleionecontrollercharactercmd.29	The bomb is being delivered...
pleionecontrollercharactercmd.30	Stand in front of the Goddess statue and touch it.
pleionecontrollercharactercmd.31	You cannot give your partner a piggyback ride when they have weapons or shields in both hands.
pleionecontrollercharactercmd.32	Cannot trade now.
pleionecontrollercharactercmd.33	You can't mount your pet if you're flying.
pleionecontrollercharactercmd.34	You're too far away.
pleionecontrollercharactercmd.35	You are too close to your opponent.
pleionecontrollercharactercmd.36	A game of Mafia is in progress. Would you like to spectate?
pleionecontrollercharactercmd.37	You can only use the Close Combat talent or Giant Full Swing when Wind Guard is active.
pleionecontrollercharactercmd.38	Only Main Characters can participate in the Festia Instant Prize Event.
pleionecontrollercharactercmd.39	You cannot mount while reforging.
pleionecontrollercharactercmd.40	Only Main Characters can participate in the Instant Prize Event.
pleionecontrollercharactercmd.41	You cannot use Expedition Bulletin Boards on someone else's Homestead.
pleionecontrollercharacteretc.0	{0} is on the lookout for an unidentified enemy.\nYou have to dismount in order to move.
pleionecontrollercharacteretc.1	You are too far away to control the puppet.\nMarionette controls disabled.
pleionecontrollercharacteretc.2	You're too far away from the pet.
pleionecontrollercharacterprocess.1	Pet command failed.
pleionecontrollercharacterprocess.2	Seems like {0} is distracted and didn't hear your command.
pleionecutscenemgrmsg.1	You don't have enough virtual memory. Now skipping cutscene.
pleionegameguard.1	A keylogger hacking tool has been discovered.
pleionegameguard.2	GameGuard is currently running. Please try again after rebooting your system.
pleionegameguard.3	There are multiple instances of the game or GameGuard is already running. Please try again after exiting the game.
pleionegameguard.4	A GameGuard initialization error has occurred. Run again after rebooting your system or close any conflicting applications and try again.
pleionegameguard.5	A GameGuard file is missing or has been tampered with. Please install GameGuard setup files.
pleionegameguard.6	Some Windows files have been corrupted. Please reinstall Internet Explorer.
pleionegameguard.7	Failed to execute GameGuard. Please reinstall GameGuard setup files.
pleionegameguard.8	An illegal program has been detected. Close any unnecessary applications and try again.
pleionegameguard.9	GameGuard update has been cancelled. If you cannot log in, configure your Internet and personal firewall settings.
pleionegameguard.10	Connection failed due to virus or spyware. Download the latest antivirus application and run a total scan on your computer.
pleionegameguard.11	A GameGuard initialization error has occurred or it's an older version file of GameGuard. Please reinstall GameGuard setup files and try again.
pleionegameguard.12	An .ini file is missing or has been tampered with. You can fix this issue by installing GameGuard setup files.
pleionegameguard.13	An npgmup.des initialization error has occurred. Delete the GameGuard folder and try again.
pleionegameguard.14	Failed to connect to the GameGuard update server. Try again later or configure your personal firewall (if applicable).
pleionegameguard.15	GameGuard update was not completed. Temporarily disable any antivirus applications and try again or configure the settings using PC Manager program.
pleionegameguard.16	Failed to load virus and hacking tool scanning modules. There may be not be enough memory or it may be infected by viruses.
pleionegameguard.17	GameGuard encountered an error during execution. Go to the GameGuard folder and send *.erl files to Game1@inca.co.kr.
pleionegameguard.18	You do not have Administrator rights. Administrator rights are needed to run the program for the first time.
pleionegameguard.19	The nProtect KeyCrypt driver version is incorrect. Please reboot your system and try again.
pleionegameguard.20	Windows XP Compatibility mode is active. The Compatibility mode has been removed from the present program. Please run the program again.
pleionegameguard.21	An unauthorized program has been detected. Please capture this screen and report it along with the Error Reporting Assistant.\n Error Number: {0}
pleionegameguard.22	GameGuard has encountered an error. Please capture this screen and report it along with the Error Reporting Assistant.\n Error Number: {0}
pleionegameguard.23	Warning
pleionegameguard.24	An unregistered error has occurred. Please capture this screen and report it along with the Error Reporting Assistant.\n Error Number: {0}
pleionegameguard.25	Failed to load keyboard protection module.
pleionegameguard.26	GameGuard initialization error : {0}
pleionegameguard.27	A Speed Hack has been detected on your computer.\nPlease report this by submitting a ticket through\nMabinogi.nexon.net>Support>Customer Support.
pleionegameguard.28	A game hack has been detected on your computer : {0}\nPlease report this by submitting a ticket through\nMabinogi.nexon.net>Support>Customer Support.
pleionegameguard.29	The game or the GameGuard has been compromised.
pleioneglobalconsole.1	DLL Load Error
pleioneglobalconsole.2	Failed to load the {0} file.\nPlease re-install the client.
pleioneglobalconsolekeyboard.1	You may not designate ESC, 1~=, F1-F12, TAB, Enter, and other system control keys as hotkey's.
pleioneglobalconsolekeyboard.2	(개발모드전용) 캡션, 프랍이름, 아이템이름을 숨김/해제합니다.
pleioneglobalconsolekeyboard.3	Activates the option of minimizing other characters.
pleioneglobalconsolekeyboard.4	Turns off the option of minimizing other characters.
pleioneglobalconsolekeyboard.5	The ESC, 1 through =, F1 through F12, Enter, and system keys cannot be bound as hotkeys.
pleionehotkeymgr.1	(Hotkey '{0}')
pleionehotkeytext.1	Use the skill #1 on the skill window
pleionehotkeytext.2	Use the skill #2 on the skill window
pleionehotkeytext.3	Use the skill #3 on the skill window
pleionehotkeytext.4	Use the skill #4 on the skill window
pleionehotkeytext.5	Use the skill #5 on the skill window
pleionehotkeytext.6	Use the skill #6 on the skill window
pleionehotkeytext.7	Use the skill #7 on the skill window
pleionehotkeytext.8	Use the skill #8 on the skill window
pleionehotkeytext.9	Use the skill #9 on the skill window
pleionehotkeytext.10	Switch to Skill Window #1
pleionehotkeytext.11	Switch to Skill Window #2
pleionehotkeytext.12	Switch to Skill Window #3
pleionehotkeytext.13	Switch to Skill Window #4
pleionehotkeytext.14	Switch to Skill Window #5
pleionehotkeytext.15	Emoticon Play #1
pleionehotkeytext.16	Emoticon Play #2
pleionehotkeytext.17	Emoticon Play #3
pleionehotkeytext.18	Emoticon Play #4
pleionehotkeytext.19	Emoticon Play #5
pleionehotkeytext.20	Emoticon Play #6
pleionehotkeytext.21	Emoticon Play #7
pleionehotkeytext.22	Emoticon Play #8
pleionehotkeytext.23	Emoticon Play #9
pleionehotkeytext.24	Emoticon Play #10
pleionehotkeytext.25	Cancel Skill
pleionehotkeytext.26	Quest Window
pleionehotkeytext.27	Change Weapon Set
pleionehotkeytext.28	Open/Close Helmet
pleionehotkeytext.29	Mount/Dismount
pleionehotkeytext.30	Pet Window
pleionehotkeytext.31	Inventory Window
pleionehotkeytext.32	Open/Hide equipment tab on the Item Inventory
pleionehotkeytext.33	Clock Window
pleionehotkeytext.34	Party Window
pleionehotkeytext.35	Open/Close Party Window
pleionehotkeytext.36	Open/Close Interface
pleionehotkeytext.37	Auto Battle/Manual Battle
pleionehotkeytext.38	On/Off remove self when targeting
pleionehotkeytext.39	Skill Window
pleionehotkeytext.40	Messenger Window
pleionehotkeytext.41	Use Antidote Potion
pleionehotkeytext.42	Use HP Potion
pleionehotkeytext.43	Use Wound Remedy Potion
pleionehotkeytext.44	Use MP Potion
pleionehotkeytext.45	Use Phoenix Feather
pleionehotkeytext.46	Use Stamina Potion
pleionehotkeytext.47	Eat Food
pleionehotkeytext.48	Message Log Window
pleionehotkeytext.49	Switch tab on the message log window
pleionehotkeytext.50	Toggle the separated tabs on the message log window
pleionehotkeytext.51	Auto POV/Manual POV
pleionehotkeytext.52	Explore using L-Rod
pleionehotkeytext.53	Character Window
pleionehotkeytext.54	View the next tab on the character window
pleionehotkeytext.55	Take Off/Land
pleionehotkeytext.56	Escape Bomb
pleionehotkeytext.57	Action Window
pleionehotkeytext.58	Open/Close Character Name
pleionehotkeytext.59	Mini Map
pleionehotkeytext.60	Speak with Spirit Weapon
pleionehotkeytext.61	Combat Mode/Normal Mode
pleionehotkeytext.62	Zoom out
pleionehotkeytext.63	Zoom in
pleionehotkeytext.64	Toggle On/Off Advanced Glow Effect
pleionehotkeytext.65	Summon 1st Pet
pleionehotkeytext.66	Summon 2nd Pet
pleionehotkeytext.67	Summon 3rd Pet
pleionehotkeytext.68	Summon 4th Pet
pleionehotkeytext.69	Summon 5th Pet
pleionehotkeytext.70	Summon 6th Pet
pleionehotkeytext.71	Summon 7th Pet
pleionehotkeytext.72	Summon 8th Pet
pleionehotkeytext.73	Summon 9th Pet
pleionehotkeytext.74	Summon 10th Pet
pleionehotkeytext.75	Cancel Pet Summon
pleionehotkeytext.76	Pet Inventory
pleionehotkeytext.77	Sit down the Pet
pleionehotkeytext.78	Call the Pet
pleionehotkeytext.79	Pet's Adorable Act
pleionehotkeytext.80	Find Pet Personal Store
pleionehotkeytext.81	Minimize other characters
pleionehotkeytext.82	Switch to Skill Window #6
pleionehotkeytext.83	Switch to Skill Window #7
pleionehotkeytext.84	Record Video
pleionehotkeytext.85	Forward
pleionehotkeytext.86	Reverse
pleionehotkeytext.87	Rotate Left
pleionehotkeytext.88	Rotate Right
pleionehotkeytext.89	Visual Chat
pleionehotkeytext.90	Emergency Escape B+ Bomb
pleionehotkeytext.91	Basic Settings
pleionehotkeytext.92	Vindictus Settings
pleionehotkeytext.93	MapleStory Settings
pleionehotkeytext.94	Dungeon Fighter Online Settings
pleionehotkeytext.95	Dragon Nest Settings
pleionehotkeytext.96	Lineage 1 Settings
pleionehotkeytext.97	Lineage 2 Settings
pleionehotkeytext.98	Aion Settings
pleionehotkeytext.99	World of Warcraft Settings
pleionehotkeytext.100	Customized Settings
pleionehotkeytext.101	Homestead Information Window
pleionehotkeytext.102	Move Left
pleionehotkeytext.103	Move Right
pleionehotkeytext.104	Keyboard Action
pleionehotkeytext.105	Change to Quick Slot Tab #1
pleionehotkeytext.106	Change to Quick Slot Tab #2
pleionehotkeytext.107	Change to Quick Slot Tab #3
pleionehotkeytext.108	Change to Quick Slot Tab #4
pleionehotkeytext.109	Change to Quick Slot Tab #5
pleionehotkeytext.110	Change to Quick Slot Tab #6
pleionehotkeytext.111	Change to Quick Slot Tab #7
pleionehotkeytext.112	Change to Quick Slot Tab #8
pleionehotkeytext.113	Move Forward
pleionehotkeytext.114	Move Back
pleionehotkeytext.115	Default Settings (move using mouse)
pleionehotkeytext.116	Default Settings (move using keyboard)
pleionehotkeytext.117	Switch to Skill Window #8
pleionehotkeytext.118	Summon Partner 1
pleionehotkeytext.119	Summon Partner 2
pleionehotkeytext.120	Summon Partner 3
pleionehotkeytext.121	Summon Partner 4
pleionehotkeytext.122	Summon Partner 5
pleionehotkeytext.123	Switch to Skill Window #9
pleionehotkeytext.124	Switch to Skill Window #10
pleionehotkeytext.125	Dressing Room/Pon
pleionehotkeytext.126	Move Targeting
pleionehotkeytext.127	B-Bomb Series
pleionehotkeytext.128	Talent Window
pleionehotkeytext.129	Use Marionette Potion
pleionehotkeytext.130	Use Marionette Repair Kit
pleionehotkeytext.131	Transformation Diary
pleionehotkeytext.132	Feed Pet HP Potion
pleionehotkeytext.133	Feed Pet MP Potion
pleionehotkeytext.134	Feed Pet Stamina Potion
pleionehotkeytext.135	Traveler's Guide
pleionehotkeytext.136	Expand Minimap
pleionehotkeytext.137	Switch to Equipment Slot 1
pleionehotkeytext.138	Switch to Equipment Slot 2
pleionehotkeytext.139	Switch to Equipment Slot 3
pleionehotkeytext.140	Switch to Equipment Slot 4
pleionehotkeytext.141	Switch to Equipment Slot 5
pleionehotkeytext.142	Switch to Equipment Slot 6
pleionehotkeytext.143	Switch to Equipment Slot 7
pleionehotkeytext.144	Switch to Equipment Slot 8
pleionehotkeytext.145	Memoir
pleionehotkeytext.146	Technique
pleionehotkeytext.147	Switch to 2nd Skill Array
pleionehotkeytext.148	Interaction Crafter
pleionehotkeytext.153	Spirit Window
pleionehotkeytext.154	Pet/Partner Info
pleionehotkeytext.155	Friend Summon Slot 1
pleionehotkeytext.156	Friend Summon Slot 2
pleionehotkeytext.157	Friend Summon Slot 3
pleionehotkeytext.158	Friend Summon Slot 4
pleionehotkeytext.159	Friend Summon Slot 5
pleionehotkeytext.160	Pet Skill Slot 1
pleionehotkeytext.161	Pet Skill Slot 2
pleionehotkeytext.162	Pet Skill Slot 3
pleionehotkeytext.163	Pet Skill Slot 4
pleionehotkeytext.164	Pet Skill Slot 5
pleionehotkeytext.165	Pet Fynn Bead Skill Slot 1
pleionehotkeytext.166	Pet Fynn Bead Skill Slot 2
pleionehotkeytext.167	Pet Fynn Bead Skill Slot 3
pleionehotkeytext.168	Pet Perk Slot
pleionehotkeytext.169	Show Summoned Pet Skills
pleionehotkeytext.170	특성 세트1 활성화
pleionehotkeytext.171	특성 세트2 활성화
pleionehotkeytext.172	특성 세트3 활성화
pleionehotkeytext.173	특성 세트4 활성화
pleionehotkeytext.174	특성 세트5 활성화
pleionelobby_msg.1	Would you like to summon the created animal character?
pleionelobby_msg.2	Failed to summon the created animal character.
pleionelobby_msg.3	Would you like to create a new animal character using the purchased card?
pleionelobby_msg.4	Failed to create a new animal character.\nPlease send a ticket to Customer Support.
pleionelobby_msg.5	Failed to create an Animal Character.\n\n* You can create a maximum of {0} characters.
pleionelobby_msg.6	Referred [{1}] from the [{0}] server.
pleionelobby_msg.7	That character does not exist.
pleionelobby_msg.8	존재하지 않는 캐릭터이거나 추천 권한이 없습니다.
pleionelobby_msg.9	확인
pleionelobby_msg.10	본인 확인이 완료된 후 다시 로그인을 해주시기 바랍니다.
pleionelobby_msg.11	Rebirth failed.
pleionelobby_msg.12	Rebirth failed.({0})\n
pleionelobby_msg.13	This pet is unavailable for rebirth.
pleionelobby_msg.14	You cannot rebirth right now.
pleionelobby_msg.15	This age is unavailable for rebirth.
pleionelobby_msg.16	There is an issue with the card that you used for rebirth.
pleionelobby_msg.17	There is an issue with the selected hair.
pleionelobby_msg.18	There is an issue with the selected face.
pleionelobby_msg.19	There is an issue with the selected hair color.
pleionelobby_msg.20	There is an issue with the selected skin color.
pleionelobby_msg.21	There is an issue with the selected eye color.
pleionelobby_msg.22	There is an issue with the selected eyes.
pleionelobby_msg.23	There is an issue with the selected mouth.
pleionelobby_msg.24	Please contact customer support.
pleionelobby_msg.25	You cannot delete the character because you have an item in item shop's storage.
pleionelobby_msg.26	Pet creation failed.\n\n*You can only create {0} characters, including pets, per account. 
pleionelobby_msg.27	You cannot use this with a pet summoned.\nTry again after de-summoning your pet.
pleionelobby_render.1	You cannot log in with a character that's waiting to be deleted.
pleionelogin.0	휴대폰 인증 데이타 초기화 중입니다.\n잠시 후 로그인하십시오.
pleionelogin.1	인증 중 다른 IP에서 접속을 하였습니다.\n{0} 후에 다시 로그인하십시오.
pleionelogin.2	휴대폰 인증사 또는 이동 통신사 장애로 인하여 휴대폰 인증없이 로그인하였습니다.
pleionelogin.3	메시지
pleionelogin.4	채널링 로그인을 실패했습니다.
pleionelogin.5	채널링 로그인을 실패했습니다.
pleionelogin.6	서버 오류가 발생했습니다. 잠시 후 다시 시도해주세요.
pleionelogin.7	서버로 잘못된 인자가 전송되었습니다. GM에게 문의하시기 바랍니다.
pleionelogin.8	인증에 실패했습니다. GM에게 문의하시기 바랍니다.
pleionelogin.9	Please log in again later.
pleionelogin.10	휴면계정으로 계정 사용이 정지되었습니다.\n자세한 사항은 2008년 7월 24일자 휴면 계정 안내 공지 및 마비노기 게임 서비스 이용약관을 참고하시기 바라며, \n계정 정지 해제를 원하실 경우 마비노기 고객지원센터(Tel: 1588-1977)로 문의하시기 바랍니다.\n감사합니다.
pleionelogin.11	넥슨 비가맹 PC방에서는 로그인을 할 수 없습니다.
pleionelogin.12	넥슨 정기 점검 중에는 PC방에서 로그인을 할 수 없습니다.
pleionelogin.13	You must start the game from the Mabinogi website.
pleionelogin.14	Hacking attempts detected. Your account has been temporarily restricted. \nPlease contact Customer Support to remove this restriction. \nThank you.
pleionelogin.15	Invalid argument.
pleionelogin.16	Invalid ID or password.
pleionelogin.17	Login time has expired.
pleionelogin.18	The Authentication Server is currently under maintenance.
pleionelogin.19	Unsupported location.
pleionelogin.20	Location setting required.
pleionelogin.21	No server information.
pleionelogin.22	IP information does not match.
pleionelogin.23	Web login is currently unavailable.
pleionelogin.24	입력하신 넥슨 아이디에는 여러개의 마비노기 계정이 존재합니다\n\n마비노기 홈페이지에서 이중 하나를 대표 계정으로 설정을 하신 후에\n넥슨 아이디로 로그인이 가능합니다.
pleionelogin.25	넥슨아이디나 암호가 올바르지 않습니다.\n\n한글/영어가 틀리지 않은지,\n대소문자가 올바로 구분되어 입력되었는지\n확인해보세요.
pleionelogin.26	지금 로그인한 컴퓨터는 등록되지 않은 컴퓨터입니다.\n먼저 홈페이지에서 등록해주세요.
pleionelogin.27	이용하고 계신 계정의 NEXON ID는 [간단회원]입니다.\n[간단회원]의 로그인 서비스는 종료했습니다.\n[NEXON회원]으로 변경을 부탁드립니다
pleionelogin.28	Your secondary passwords do not match.
pleionelogin.29	You have entered the wrong password {0} time(s).\nYou will be unable to log in after your fifth attempt.
pleionelogin.30	Your login attempt failed. Please try again or check to see if the game is undergoing maintenance.
pleionelogin.31	You cannot log in because you've entered the wrong secondary \npassword 5 times. Please go to the website and reset \nyour secondary password.
pleionelogin.32	Please visit and login to our website to agree\nto the new Terms of Use first to play Mabinogi.
pleionelogin.33	Your account has been blocked due to chargeback / reversed payment.\nPlease contact Customer Support on www.nexoneu.com for further queries.
pleionelogin.34	죄송합니다. 나이가 만 12세 미만인 계정으로는 로그인할 수 없습니다.
pleionelogin.35	이메일ID로만 로그인할 수 있습니다.\n이메일ID로 전환 후 로그인해주세요.
pleionelogin.36	오후 {0}시
pleionelogin.37	오전 {0}시
pleionelogin.38	청소년보호법 제23조에 따라\n16세 미만의 청소년은 {0:minTime}부터 {1:maxTime}까지 로그인이 제한됩니다.\n\n관련된 문의사항은 넥슨 고객센터로 문의 바랍니다.
pleionelogin.39	고객님의 계정은 장기간 로그인하지 않아, 계정 보호 상태로 설정되었습니다.\n마비노기 홈페이지에 로그인하시면 계정 보호 상태를 해제하실 수 있습니다.
pleionelogin.40	마비노기 계정을 생성하는 데 실패했습니다.\n잠시 후 다시 시도해주세요.\n\n문제가 지속되면 넥슨 고객센터로 문의해주시기 바랍니다.
pleionelogin.41	로그인 중 오류가 발생했습니다.\n잠시 후 다시 시도해주세요.\n\n문제가 지속되면 넥슨 고객센터로 문의해주시기 바랍니다.
pleionelogin.42	이메일ID로 전환된 사용자입니다.\n이메일ID로 로그인해주세요.
pleionelogin.48	마비노기 계정 목록을 불러오는데 실패했습니다.
pleionelogin.49	You exceeded the selection time limit.\nPlease log in again.
pleionelogin.50	The session information is incorrect({0}).\nPlease log in again.
pleionelogin.52	Failed to chagneNexon ID on item market.\n(0x%08X)
pleionelogin.53	현재 로그인한 컴퓨터에서는 게임에 접속할 수 없습니다.
pleionelogin.54	사용 정지된 계정입니다.\n자세한 사항은 마비노기 홈페이지 고객센터를 통하여 문의해주시기 바랍니다.
pleionelogin.55	아이디나 비밀번호가 올바르지 않습니다.\n\n한글/영어를 다르게 입력한 건 아닌지,\n대소문자를 올바로 구분해 입력했는지 확인해 보세요.
pleionelogin.57	일일 이용 가능한 게임 시간대를 초과하여, 잠시 후 접속이 종료됩니다.
pleionelogin.58	일일 이용 가능한 게임 시간대를 초과하여, {0}분 후 접속이 종료됩니다.
pleioneloginstage.1	오류가 발생했습니다. 잠시 후 다시 시도해주세요.
pleioneloginstage.2	보안 오류입니다.
pleioneloginstage.3	Issuer의 ID가 잘못되었습니다.
pleioneloginstage.4	인자가 잘못되었습니다.
pleioneloginstage.5	알 수 없는 오류가 발생했습니다. 잠시 후 다시 시도해주세요..
pleioneloginstage.6	인증서버의 내부오류가 발생하였습니다. 잠시 후 다시 시도해주세요.
pleioneloginstage.7	ID나 비밀번호가 잘못되었습니다. 확인 후 다시 로그인해주세요.
pleioneloginstage.8	이 계정은 블럭된 상태입니다. GM에게 문의하시기 바랍니다.
pleioneloginstage.9	인증 서버가 정기점검중입니다. 공지를 확인하시고 점검이 끝난 후 다시 로그인해주세요.
pleioneloginstage.10	시스템 오류가 발생했습니다. 잠시 후 다시 로그인해주세요.
pleioneloginstage.11	이 IP는 블럭된 상태입니다. GM에게 문의하시기 바랍니다.
pleioneloginstage.12	계정이 잠겨져 있습니다. GM에게 문의하시기 바랍니다.
pleioneloginstage.13	과도한 접속 시도가 이루어졌습니다. GM에게 문의하시기 바랍니다.
pleioneloginstage.14	SMC 인증 방식에 문제가 발생했습니다.
pleioneloginstage.15	보안 오류가 발생했습니다. GM에게 문의하시기 바랍니다.
pleioneloginstage.16	보안 모듈을 읽는데 실패했습니다. 게임을 재설치하시기 바랍니다.
pleioneloginstage.17	보안 모듈을 읽는데 실패했습니다.
pleioneloginstage.18	신분 정보가 완전하지 않습니다. 공식홈페이지에서 추가 완성 해주세요.
pleioneloginstage.19	암호화 문자열 성공여부 : {0} \n
pleioneloginstage.20	인증서버 초기화에 실패하였습니다.
pleioneloginstage.21	요청 시간이 초과하였습니다.
pleioneloginstage.22	인증 코드 오류입니다.
pleioneloginstage.23	암호 보호정보 오류입니다.
pleioneloginstage.24	계정 혹은 암호 오류입니다.
pleioneloginstage.25	사용정지 당한 계정아이디 입니다.
pleioneloginstage.26	차단된 IP 입니다.
pleioneloginstage.27	중복 로그인 입니다.
pleioneloginstage.28	기타 오류 혹은 인증 과정에 문제가 생겼습니다.
pleioneloginstage.29	클로즈 베타 기간 입니다.
pleioneloginstage.30	서버가 점검 상태에 있습니다.
pleioneloginstage.31	모바일 게임 유저 신분정보가 완전하지 않습니다.
pleioneloginstage.32	알 수 없는 이유로 인증에 실패하였습니다({0}).
pleioneloginstage.33	해당 계정은 사용 불가능합니다. 고객상담센터에 연락하시길 바랍니다.
pleioneloginstage.34	토큰 비번 입력 오류입니다. [세기천성 계정관리 APP]를 다시 확인하시길 바랍니다.
pleioneloginstage.35	계정이 등록 정보 수정 정지기간중에 있음.자세한 사항은 고객센터로 문의하세요!
pleioneloginstage.36	비밀번호 유효기간이 만료되었습니다. 비밀번호를 변경해 주세요.
pleionemessenger.1	{0} [{1}] has added you to their friend's list.\nDo you accept?
pleionemessenger.2	{0} [{1}]\n has logged in.
pleionemessenger.3	You have received a note\nfrom {0} [{1}]
pleionemessenger.4	You are not logged into the messenger, or your Family is not valid.
pleionemessenger.5	You are not logged into the messenger, or your Family is not valid.
pleionemessengerbase.1	Blocked
pleionemessengerbase.2	Inviting
pleionemessengerbase.3	Offline
pleionemessengerbase.4	Online
pleionemessengerbase.5	Secret
pleionemessengerbase.6	Out to Lunch
pleionemessengerbase.7	Away
pleionemessengerbase.8	In Combat
pleionemessengerbase.9	Doing Business
pleionemessengerbase.24	Unknown
pleionemessengerbase.25	Recently logged on
pleionemessengerbase.26	Logged on {0} mins ago
pleionemessengerbase.27	Login time unknown
pleionemessengerbase.28	Logged on {0} hrs ago
pleionemessengerbase.29	Logged on {0} days ago
pleionemessengerbase.30	Logged on {0} weeks ago
pleionemessengerbase.31	Has not logged in for over {0} weeks
pleionemessengerbase.32	모바일
pleionemessengerbase.33	In Mini-game
pleionemessengerbase.34	In Mini-game
pleionemessengerbase.35	In Mini-game
pleionemessengerclient_impl.1	ETC.
pleionemessengerclient_impl.2	This user has already been registered as a friend.
pleionemessengerclient_impl.3	Unable to locate the user. Please double-check the character name and the server.
pleionemessengerclient_impl.4	You cannot add any more friends.
pleionemessengerclient_impl.5	You cannot add a character from your own account on your friend's list.
pleionemessengerclient_impl.6	You cannot add your pet character to the friend's list.
pleionemessengerclient_impl.7	Failed to add th euser as a friend for unknown reasons.\nTry again later, and if the problem persists, please report this issue.
pleionemessengerclient_impl.8	The note has been sent.
pleionemessengerclient_impl.9	Unable to find the recipient.
pleionemessengerclient_impl.10	Unable to send the note. Please try again later.
pleionemessengerclient_impl.11	Unable to obtain the guild member's information.
pleionemessengerclient_impl.12	Blacklist
pleionemessengerclient_impl.13	You can't add this person because their friend list is full.
pleionemessengerclient_impl.14	(모바일)
pleionemessengerclient_impl.15	{0} has entered the Family Channel.
pleionemessengerclient_impl.16	{0} has left the Family Channel.
pleionemessengersession.1	{0} has left the room.
pleionemessengersession.2	{0} has entered the room.
pleionemessengersession.3	{0} [{1}] says\n
pleionenexonmsgr.1	An error has occurred during authorization. Unable to connect to SSO authorization server.
pleionenexonmsgr.2	Authorization service for Nexon login is under maintenance.
pleionenexonmsgr.3	Blocked IP.
pleionenexonmsgr.4	Blocked by administrator.
pleionenexonmsgr.5	Passport has encountered an error, and you can't log into the game.
pleionenexonmsgr.6	The ID does not exist.
pleionenexonmsgr.7	Incorrect password.
pleionenexonmsgr.8	Your password has expired. Change your password, and re-log into the game.
pleionenexonmsgr.9	E-mail requires to be verified. Please verify your e-mail, and re-log into the game.
pleionenexonmsgr.10	Blocked IP.
pleionenexonmsgr.11	Change your password, and re-log into the game.
pleionenexonmsgr.12	An error occurred during initializing messenger module. Unable to connect to the server.
pleionenexonmsgr.13	Failed to initialize messenger module.
pleionenexonmsgr.14	Nexon Authorization has encountered an error.
pleionenexonmsgr.15	Nexon Authorization has encountered an error. (Error Code: {0})
pleionenexonmsgr.16	Nexon Authorization has encountered an error. (Error Code: {0})
pleionenexonmsgr.17	해외 로그인 차단 기능이 실행되었습니다. 넥슨닷컴에서 로그인하시면 본인확인을 통해 안전하게 로그인 할 수 있습니다.
pleionenexonmsgr.18	You have been flagged for suspicious activity and will be unable to log in at this time. Please contact Customer Support for more information.
pleionenexonmsgr.19	회원가입 완료를 위해 이메일 인증이 필요합니다.\n인증메일 확인 후 다시 시도해주세요.
pleionenexonmsgr.20	고객님의 넥슨ID는 휴면상태입니다. 넥슨닷컴 로그인을 통해 휴면 해제후 서비스를 이용할 수 있습니다.
pleioneslotroulette_render.1	Press New Partner to create a new partner,\nor select a character to be reborn and press Rebirth.
pleionesurveymanager.1	Elf
pleionesurveymanager.2	Giant
pleionesurveymanager.3	Human
pleioneusecard.1	Character creation failed.\n\n* You can only create 20 characters per race.
pleioneusecard.2	Character creation failed.\n\n* Your character card could not be found.\n*Please take a screenshot of the current screen and submit a ticket to Customer Support.
pleioneusecard.3	Character creation failed.\n\n* You can only create {0} characters per account.
pleioneusecard.4	Character creation is currently disabled to prepare for the server merge.
pleioneusecard.5	Pet creation failed.\n\n*You can only create {0} characters, including pets, per account.
pleioneusecard2.1	Create New Partner
pleioneusecard2render.1	{0} Server
pleioneusecardrender.1	{0} Server
plw_achievement.1	'{0}' Journal Acquisition has been reset.
plw_achievement.2	{0} in Mabinogi
plw_actioneffect.1	The Seal has happily eaten the fish.
plw_actioneffect.2	You've become small enough to fit through the small hole.
plw_actioneffect.3	You have returned to your normal size because the effects of the mini potion wore off.
plw_actioneffect.4	Royal Castle Banquet Participation Experience +{0} EXP
plw_actioneffect.5	You received a Lucky Bonus (Luck {0}).
plw_actioneffect.6	You received a Huge Lucky Bonus (Luck {0})!
plw_actioneffect.7	The fallen will revive in {0} second(s).
plw_actioneffect.8	Renown reached level {1} through {0}!
plw_actionmove.1	The skill has been canceled because you are out of range.
plw_actionmsg.1	You have requested {0} for a summon.\nWaiting for his/her response...
plw_actionmsg.2	Cancel
plw_actionmsg.3	Cannot find {0}.
plw_actionmsg.4	Failed to request {0} for a summon.
plw_actionmsg.5	I’ve successfully summoned my friend.
plw_actionmsg.6	The summon request has been denied.
plw_actionmsg.7	I’ve stopped the summoning of my friend.
plw_actionmsg.8	{0} has requested you for a summon.\nWould you like to accept?
plw_actionmsg.9	He/she has canceled my summon.
plw_actionmsg.10	AP has increased by {0}.
plw_actionmsg.11	There is an obstacle preventing you from jumping.
plw_additionalequipsystem.1	You can't use an extra equipment slot right now.
plw_advertisecomponent.0	You have received {0}'s flyer.
plw_advertisecomponent.1	This flyer has expired.
plw_advertisecomponent.2	This is currently not available.
plw_airballoon.1	A hot air balloon that floats in the sky. No worries if you're not the one who created the hot air balloon! You can always get on it simply by joining the party belonging to the person who created the balloon.
plw_apskilltrain.1	Use {0} AP to train the skill? \n {1} AP Remaining
plw_apskilltrain.2	You don't have enough AP to train the skill. You need {0} AP to train this skill. \n {1} AP Remaining
plw_apskilltrain.3	You have successfully trained the skill.
plw_apskilltrain.4	You cannot train the skill.
plw_auctionmgr.1	That item does not exist.
plw_auctionmgr.2	Your bank data could not be imported.
plw_auctionmgr.3	Your password is incorrect.\n
plw_auctionmgr.4	The lowest sale price data could not be found\nbecause there are no current listings.
plw_auctionmgr.5	The data import failed.\nPlease try again later.
plw_auctionmgr.6	[Auction House]\nThe item has been sold.
plw_auctionmgr.7	[Auction House]\nYou have been outbid.
plw_auctionmgr.8	[Auction House]\nYou won the bid for the item.
plw_aviationcomponent.1	I’d better increase my altitude if I want to move.
plw_aviationcomponent.2	I can’t move any further in the current direction.
plw_aviationcomponent.3	You have canceled moving to the waypoint.
plw_aviationcomponent.4	Cannot fly in this area; your waypoints will be reset shortly.
plw_aviationcomponent.5	You are restricted from flying in this area.
plw_aviationcomponent.6	You are restricted from landing and taking off from this area.
plw_aviationcomponent.7	Cannot take off during a break.
plw_aviationcomponent.8	You are restricted from landing and taking off from this area.
plw_aviationcomponent.9	You can only land when your altitude is around 15m.
plw_aviationcomponent.10	Please press \'V\' to land.
plw_aviationcomponent.11	Altitude: %.1fm
plw_aviationcomponent.12	Altitude: {0}m
plw_aviationcomponent.13	Press <hotkey name=\"TakeOff\"/> to land.
plw_aviationcomponent.14	You can't trade and fly at the same time.
plw_aviationcomponent.15	You can't fly if you're with your pet.
plw_bankmgr.1	Please re-try in {0} sec.
plw_bankmgr.2	The bank has not opened properly.
plw_bankmgr.3	The password is incorrect.
plw_bankmgr.4	An error has occurred.
plw_bankmgr.5	The password is incorrect.
plw_banquet.1	{0} second(s)
plw_banquet.2	approximately {0} minute(s)
plw_banquet.3	{0} minute(s)
plw_banquet.4	the Royal Castle Banquet will start.
plw_banquet.5	The Royal Court Banquet will start in {0:n minute(s) and m second(s)}
plw_banquet.6	The Royal Court Banquet will end soon.
plw_banquet.7	The Royal Court Banquet will end in {0:n minute(s) and m second(s)}
plw_banquet.8	Please select the dish you want to serve. You can only serve a high level dish.
plw_banquet.9	Leave a thank you for {0}.\nWill be sent to {0} as a Note.
plw_banquet.10	Table
plw_banquet.11	It's full of food provided for the Royal Castle.\nDo you wish to eat?
plw_banquet.12	Eat
plw_banquet.13	Serve Food
plw_banquet.14	Cancel
plw_banquet.15	You've served some food.
plw_banquet.16	There seems to be no more food left.
plw_banquet.17	You're still quite full. You should try eating again later.
plw_banquet.18	The table theme has been selected!\nA sign has been successfully put up.
plw_banquet.19	The table theme has been deleted!
plw_banquet.20	The selected theme is already being used at a different table.\nPlease change the theme for this table.
plw_banquet.21	You can't use that as the theme.
plw_banquet.22	Theme : {0}\nProposer : {1}\n\nTheme can be changed {2}.
plw_banquet.23	You cannot delete a theme that you didn't select.
plw_banquet.24	You can't delete the theme.
plw_bardboardmgr.1	No Music Scores
plw_bardboardmgr.2	You cannot transcribe Music Scores while mounted.
plw_bardboardmgr.3	You cannot transcribe Music Scores because you are using a different skill.
plw_bardboardmgr.4	Cannot transcribe without the Composing skill.
plw_bardboardmgr.5	Your Composing skill is not high enough to transcribe this song!
plw_bardboardmgr.6	Rank {0}
plw_bardboardmgr.7	Practice
plw_bardboardmgr.8	Music Score post has been registered.
plw_bardboardmgr.9	Music Score post failed to register.
plw_bardboardmgr.10	{0}/{1}
plw_bardboardmgr.11	Liked!
plw_bardboardmgr.12	Successfully edited the composer's comments.
plw_bardboardmgr.13	Failed to edit the composer's comments.
plw_bardboardmgr.14	Successfully deleted Music Score post. 
plw_bardboardmgr.15	Failed to delete Music Score post.
plw_beautyshop.1	You have entered the Beauty Shop.
plw_beautyshop.2	You haven't entered the Beauty Shop.
plw_beautyshop.3	You've left the Beauty Shop.
plw_beautyshop.4	You've made a purchase. \n{0} Pon left.
plw_beautyshop.5	You've requested an invalid Appearance Change.
plw_brionacsword.1	"{0}" trained {1} time(s).
plw_brionacsword.2	Shock absorbed. A power within has awakened.
plw_brionacsword.3	The power of the Brionac is disappearing.
plw_brionacsword.4	The Brionac could not be restored.
plw_brionacsword.5	The Brionac was restored by {0} points.
plw_brionacsword.6	A power sealed within the Brionac has awakened.
plw_cashitem.1	선택한 상품의 청약철회가 완료 되었습니다.
plw_cashitem.2	청약철회 과정에 문제가 발생하였습니다. \n 잠시 뒤에 다시 시도해 보세요.
plw_cashitem.3	청약철회가 불가능한 상품입니다.
plw_cashitem.4	구매한지 7일이 초과되어 청약철회가 불가능합니다.
plw_cashitem.5	상품의 가격이 0원인 상품은 청약철회를 신청 할 수 없습니다.
plw_cashitem.6	청약 철회이 불가능한 상품입니다.\n 오류번호 : {0} 
plw_castle.0	{0} Gold from the Guild Deposit\nwas transferred to the Castle Deposit.\n\nAvailable Balance in the Castle Deposit : {1} Gold\nAvailable Balance in the Guild Deposit : {2} Gold
plw_castle.1	Failed to transfer the Gold from the Guild Deposit to the Castle Deposit.\n\nAvailable Balance in the Castle Deposit : {0} Gold\nAvailable Balance in the Guild Deposit : {1} Gold
plw_castle.2	{0} Gold in the Guild Deposit\nhas been transferred to the castle.\n\nAvailable Balance in the Castle Deposit : {1} Gold\nAvailable Balance in the Guild Deposit : {2} Gold
plw_castle.3	Failed to transfer Gold from the Guild Deposit to the Castle Deposit.\n\nAvailable Balance in the Castle Deposit : {0} Gold\nAvailable Balance in the Guild Deposit : {1} Gold
plw_characteraction.1	Your new nose is still settling in. Please try again after {0} seconds.
plw_characteraction.3	You can't burn this item like that.
plw_charactercommonapi.1	Both hands must be free in order to perform a Transmutation.
plw_characteretc.1	청소년보호법에 따라 한 시간 후부터 다음날 오전 6시까지 16세 미만의 게임 이용이 제한됩니다.
plw_characteretc.2	청소년보호법에 따라 30분 후부터 다음날 오전 6시까지 16세 미만의 게임 이용이 제한됩니다.
plw_characteretc.3	청소년보호법에 따라 5분 후부터 다음날 오전 6시까지 16세 미만의 게임 이용이 제한됩니다.
plw_characteretc.4	청소년보호법에 따라 지금부터 다음날 오전 6시까지 16세 미만의 게임 이용이 제한됩니다.
plw_characterevent.1	Since your character is over the age of 20, your character is eligible for a free rebirth.\nRebirth will alow you to reset your character's age and level, while maintaining the skill ranks.\nResetting the level will allow you to quickly gain AP, which will allow you to grow your character at a much faster pace.\nDo you wish to go through rebirth?
plw_characterevent.2	Rebirth
plw_characterevent.3	Cancel
plw_characterevent.4	You are currently engaged in commerce. You cannot rebirth at this time.
plw_charactervmmessage.1	Select the item to repair.
plw_charactervmmessage.2	The item repair was successful.
plw_charactervmmessage.3	The item repair failed.
plw_charactervmmessage.4	Select the item to improve durability.
plw_charactervmmessage.5	The durability of the item has been improved.
plw_charactervmmessage.6	Failed to improve the durability of the item.
plw_charactervmmessage.7	The advancement test cannot be held due to insufficient enrollment.\nIf you still want to take the test, you may join the test applicants that are one dan lower than you.\nPlease remember: you will only gain 50% of the Dan EXP upon passing the test.\nWould you like to join the applicants for a test?
plw_charactervmmessage.8	Write your wish on this piece of paper.
plw_charactervmmessage.9	You can trade the Wish Notes for a gift based on the number of notes you have.\nYou currently have {0} Wish Notes.\nWould you like to trade?
plw_charactervmmessage.10	Trade Wish Notes
plw_charactervmmessage.11	Yes\n
plw_charactervmmessage.12	No\n
plw_charactervmmessage.13	You failed to dismantle the Barrier Spikes.
plw_charactervmmessage.14	You cannot access any dungeons here with an Unrestricted Dungeon Pass.
plw_charactervmmessage.15	Unable to create an Unrestricted Dungeon Pass List Window.
plw_charactervmmessage.16	Failed to transmit Visual Chat.
plw_charactervmmessage.17	Failed to receive Visual Chat.
plw_charactervmmessage.18	Failed to receive {0}'s Visual Chat.
plw_charactervmmessage.19	골드 콤보카드 사용기한이 연장되었습니다.
plw_charactervmmessage.20	The Expiration date was extended.
plw_charactervmmessage.21	Failed to use Combo card extension item.
plw_charactervmmessage.22	You used a Combo Card Revival Coupon.
plw_charactervmmessage.23	Failed to use the Combo Card Revival Coupon.
plw_charactervmmessage.24	You have {0} Combo Cards that will expire in 5 or less days.
plw_charactervmmessage.25	Failed to obtain item from Independence Day Gachapon. 
plw_charactervmmessage.26	You used a Combo Card Revival Coupon.
plw_charactervmmessage.27	Failed to use the Combo Card Revival Coupon.
plw_charactervmmessage.28	You have {0} Combo Cards that will expire in 5 or less days.
plw_charactervmmessage.29	Failed to obtain item from Independence Day Gachapon. 
plw_charactervmmessage.30	Fishing\nAsk to Fish together
plw_charactervmmessage.31	{0} wants to go fishing with you. Do you accept?
plw_charactervmmessage.32	Accept
plw_charactervmmessage.33	Decline
plw_charactervmmessage.34	Failed to repair the item. Max Durability was decreased by 1.
plw_charactervmmessage.35	Time limits removed from combo card.
plw_charactervmmessage.36	Your Permanent Combo Card Coupon didn't work.
plw_charactervmmessage.37	Registered Recall Book No. {0}.
plw_charactervmmessage.38	Unable to register.
plw_charactervmmessage.39	Moved to [{0}] location.
plw_charactervmmessage.40	Can be used only once a day. Resets at midnight.
plw_charactervmmessage.41	Unable to move to the location.
plw_charactervmmessage.42	That cannot be used.
plw_charactervmmessage.43	Pet color changed!
plw_charactervmmessage.44	Pet color changed!
plw_charactervmmessage.45	Confirm
plw_charactervmmessage.46	Take {0}'s bomb within 3 seconds!
plw_charactervmmessage.47	You have no saved locations.
plw_charactervmmessage.48	Do you wish to teleport to {0}?
plw_charactervmmessage.49	Teleports you to the saved location.\nDo you wish to teleport now?
plw_charactervmmessage.50	You don't have enough money to watch the Saga.
plw_charactervmmessage.51	You don't have a needed item to watch the Saga.
plw_charactervmmessage.52	You don't have enough Pon to watch the Saga.
plw_charactervmmessage.53	You are currently watching a different episode of the Saga.
plw_charactervmmessage.54	Pon Coin Error: Please try again.
plw_charactervmmessage.55	You've already watched this episode. Please use the Replay service to watch it.
plw_charactervmmessage.56	Hero Support is complete.
plw_charactervmmessage.57	존재하지 않는 캐릭터 입니다. 다시 선택해주세요
plw_charactervmmessage.58	Ask to Rest Together
plw_charactervmmessage.59	{0} wants to rest with you. Do you accept?
plw_charactervmmessage.60	You must learn the Rest skill to use it.
plw_charactervmmessage.61	Dungeon Entrance
plw_charactervmmessage.62	A Treasure Dungeon has been detected!\nAre you up to the challenge?\nBeware! The dungeon will disappear if you fail.
plw_charactervmmessage.63	[{0}] quest is in progress.\nRemove the existing quest and receive a new quest?
plw_charactervmmessage.64	You can only receive 1 Traveler Quest regardless of type.\nReceive [{0}] Quest?
plw_charactervmmessage.65	Traveler's Guide
plw_charactervmmessage.66	Failed to use the item.
plw_charactervmmessage.67	You can't shuffle your bingo board indoors.
plw_charactervmmessage.68	You got bingo!\n\nPress the Close button to shuffle the board.
plw_charactervmmessage.69	투표권이 없습니다.
plw_charactervmmessage.70	Recharge complete!\nShuffles Left: {0}, Current Pon: {1}
plw_charactervmmessage.71	Recharge failed. Please try again.
plw_charactervmmessage.72	현재 투표할 수 없습니다.
plw_charactervmmessage.73	{1} with color number {0}
plw_charactervmmessage.74	Sit Together Request
plw_charactervmmessage.75	{0} wants to sit with you.\nAccept?
plw_charactervmmessage.76	Failed to register MabiNovel.\nPlease try again later.
plw_charactervmmessage.77	You can't read while talking to a NPC or using the board.
plw_charactervmmessage.78	You cannot move at this time.
plw_charactervmmessage.79	은행 직거래를 이용할 수 없는 상태입니다.
plw_charactervmmessage.80	알림
plw_charactervmmessage.81	Your search yielded no results.
plw_charactervmmessage.82	You must be in the same channel as the petitioner posting the request.
plw_charactervmmessage.83	Invitation code entered.
plw_charactervmmessage.84	Failed to enter invitation code. Make sure you have the right code and try again.
plw_charactervmmessage.85	You can't perform a Direct Bank Transaction right now.
plw_charactervmmessage.86	Notice
plw_charactervmmessage.87	Unable to verify cost.
plw_charactervmmessage.88	You received the item.
plw_charactervmmessage.89	Failed to purchase the item.
plw_charactervmmessage.90	Your peepers have been changed to {0}.
plw_charactervmmessage.91	The object can be re-installed, since it was removed more than 5 minutes after its initial installation.
plw_charactervmmessage.92	Soon
plw_charactervmmessage.93	{0}, your turn is coming up! Please wait on the red carpet in front of the podium!\nYou are currently {1} in line. \n\nCaution: If you're not on the red carpet when it's your turn, your turn will be forfeit.
plw_charactervmmessage.94	About 5 min
plw_charactervmmessage.95	About 10 min
plw_charactervmmessage_view.1	{0} wants to sit on the\n{1} with you.\nAccept?
plw_charactervmmessage_view.2	You cannot refer characters who are on a different server.
plw_charactervmmessage_view.3	If the other character has not been set as the main character for the Fantastic Memory event, you cannot refer them.
plw_charactervmmessage_view.4	Characters must be in the same channel to enter the referral code.
plw_charactervmmessage_view.5	You cannot use Fynn Sync right now.\nPlease try again later.
plw_checkbagcomponent.1	Store the {0} inside the {1}?
plw_checkbagcomponent.2	You can't store any more checks.
plw_checkbagcomponent.3	Select the check you wish to remove.
plw_combatant.1	This isn't enough power to damage anything.
plw_combatant.2	You must put more force behind your attacks.
plw_combatmgretc.1	Smash would work wonders against others using Defense skill.
plw_combocard.1	The Customize Combo Card feature can't be used.
plw_combocard.2	This Combo Card is expired.
plw_combocard.3	This Combo Card cannot be customized.
plw_combocard.4	The previous skill is incompatible, so it can't be customized.
plw_combocard.5	The skill to be changed is incompatible, so it can't be customized.
plw_combocard.6	The damage bonus is not right, so it can't be customized.
plw_combocard.7	Due to an unknown error, the Customize Combo Card feature is unavailable.
plw_combocard.8	You don't have enough advancement badges.
plw_combocard.9	You cannot customize Combo Cards at this time.
plw_commerce.1	Trade Good Description
plw_commerce.2	Basic Info
plw_commerce.3	Current Qty: {0}
plw_commerce.4	Charge Slots: {0}
plw_commerce.5	Per Unit Weight: {0}
plw_commerce.6	Transport Info
plw_commerce.7	Point of Origin: <color=5>{0}</color>
plw_commerce.8	Purchase Price: <color=5>{0} Ducats</color>
plw_commerce.9	Estimated Selling Price
plw_commerce.10	<color=4>This is a Trade Good purchased at this Trading Post.</color>
plw_commerce.11	<color=5>{0} Ducats</color>
plw_commerce.12	The battle has ended.
plw_commerce.13	Press the <hotkey name=\"Riding\"/> key to recover your Trade Goods and continue transporting.
plw_commerce.14	Error
plw_commerce.15	Error
plw_commerce.16	You reached\n<ttfenglish size=22>Level {0}
plw_commerce.17	{0} Merchant Rating
plw_commerce.18	{0:productName} {1:productCount}{2:productUnit}
plw_commerce.19	Exchange Info
plw_commerce.20	Error retrieving material list.
plw_commerce.21	\n {0} {1}
plw_commerce.22	<color=2>\n {0} {1}</color>
plw_commerce.23	Material needed for exchange: {0}
plw_commerce.24	<color=4>This Trade Good cannot be sold at this Trading Post.</color>
plw_commerce.25	Stop Trading
plw_commerce.26	There is at least one Trade Good that cannot be traded for Ducats.\nGive up the trade?
plw_commerce.27	시간이 초과되었습니다. 당분간 교역을 할 수 없습니다.
plw_commerce.28	틀렸습니다. 당분간 교역을 할 수 없습니다.
plw_condition.1	Auto-battle mode will be turned off when the Tower Cylinder is in use.
plw_demigod.1	Morrighan
plw_demigod.2	Neamhain
plw_demigod.3	None
plw_discipletransform.1	Successfully recharged {0} point(s).
plw_dungeonrankingmgr.1	Failed to compile the rankings.
plw_dungeonrankingmgr.2	See Ranking
plw_dungeonrankingmgr.3	Failed to compile the rankings.
plw_dungeonrankingmgr.4	See Ranking
plw_echostonecomponent.1	<color=5>{0} Grade</color>\n
plw_echostonecomponent.2	Unique Abilities\n<color=3>{0} {1} Boost</color>\n
plw_echostonecomponent.3	Supplementing level {0} Echostone.\n(Additional Stats +{1} - {2})
plw_echostonecomponent.4	Supplement Echostone
plw_equipmentcollectioncomponent.1	OK
plw_equipmentcollectioncomponent.2	Once locked the item will not be retrievable for {0} day(s).\nDo you wish to lock?
plw_equipmentcollectioncomponent.3	You cannot use this here.
plw_equipmentcollectioncomponent.4	You cannot use while mounted on a mount.
plw_equipmentcollectioncomponent.5	You cannot use while in combat.
plw_equipmentcollectioncomponent.6	You cannot use while dead.
plw_equipmentcollectioncomponent.7	You cannot use while trading.
plw_equipmentcollectioncomponent.8	You cannot use while in PvP.
plw_equipmentcollectioncomponent.9	You cannot use while using a skill.
plw_equipmentcollectioncomponent.10	You cannot use while trading or talking to a NPC.
plw_equipmentcollectioncomponent.11	You cannot use while jousting.
plw_equipmentcollectioncomponent.12	You cannot use while in a Fashion Show
plw_equipmentcollectioncomponent.13	You can't use this when you're a Demigod.
plw_equipmentcollectioncomponent.14	Cannot be used while flying.
plw_equipmentcollectioncomponent.15	\n----------------\n[Used Coupon]\n{0}
plw_equipmentcollectioncomponent.16	You spent {0} Pon.\n
plw_erinnlandachievementmgr.1	{0} Wins
plw_erinnlandachievementmgr.2	{0} Losses
plw_erinnlandachievementmgr.3	{0}%
plw_event.1	Steal lazy Pan's flag and show him how it's done!
plw_event.2	You must retrieve the Blue Team's flag, which is located on the opposite side of the play field.
plw_event.3	Steal the opposing team's flag and bring it to the flag next to Lorna.
plw_event.4	Hurry! The Blue Team's flag is located to the south.
plw_event.5	Steal Pan's blue flag and bring it back to our team.
plw_event.6	Capture the flag! You can't win unless you steal the opposing team's flag.
plw_event.7	Charge towards that violent girl Lorna's flag!
plw_event.8	Sometimes, a strong offense is the best defense. Steal the opposing team's flag! 
plw_event.9	There's no time to be lazy. Bring back the Red Team's flag!
plw_event.10	You just have to steal Lorna's red flag and bring it back to where our team's flag is.
plw_event.11	My Score: {0} point(s)
plw_event.12	{0} person(s)
plw_event.13	Red Team
plw_event.14	Blue Team
plw_event.15	 along with {0} other person(s)
plw_event.16	 - {0} point(s)
plw_event.17	You are on the Red Team for the Water Balloon event.
plw_event.18	You are on the Blue Team for the Water Balloon event.
plw_event.19	You have fed the Owl {0} time(s).
plw_event.20	You have fed the Tiger Cub {0} time(s).
plw_event.21	해당 경기에 대해 이미 응모한 쿠폰이 있습니다.{0}\n재응모하시겠습니까?
plw_event.22	월드컵 이벤트 응모
plw_event.23	Lottery Event
plw_event.24	You're the winner of the Lottery Event!\nDo you want to announce it to the world?\nIf you don't,\nit will be announced to all channels without your name.
plw_event.25	Yes
plw_event.26	No
plw_event.27	Can't be found.
plw_event.28	I can't race without my pet.
plw_event.29	I can't race without my pet.
plw_event.30	I think I'm off course.
plw_event.31	Opponent's Location
plw_event.32	We could not load your information for the Timed Item Event.
plw_event.33	You could not receive the item.
plw_event.34	You cannot use this item because you don't have any Briogh accumulated.
plw_event.haberdasherevent	Get a Peddler Coin.
plw_family.1	Family System\nAgreement to Join Family
plw_family.2	The {0} Family has sent a join request. Would you like to join?
plw_family.3	Yes
plw_family.4	No
plw_family.5	who is {0}'s Wife
plw_family.6	who is {0}'s Husband
plw_family.7	who is {0}'s Mother
plw_family.8	who is {0}'s Father
plw_family.9	who is {0}'s Older Sister
plw_family.10	who is {0}'s Older Sister
plw_family.11	who is {0}'s Older Brother
plw_family.12	who is {0}'s Older Brother
plw_family.13	who is {0}'s Daughter
plw_family.14	who is {0}'s Son
plw_family.15	who is {0}'s Younger Sister
plw_family.16	who is {0}'s Younger Brother
plw_family.17	This name is available.
plw_family.18	This name cannot be used.\nPlease use a different name.
plw_family.19	{0} has agreed to create a Family.
plw_family.20	{0} has not agreed to create a Family.
plw_family.21	You cannot receive consent because your spouse is not near by.
plw_family.22	Cannot obtain spousal consent.
plw_family.23	Family System\nFamily Creation Agreement
plw_family.24	Do you agree with your spouse, {0}, in creating the {1} Family?
plw_family.25	Failed to create a Family.\nPlease check the Family name.
plw_family.26	Failed to create a Family.\nPlease check the Family name.
plw_family.27	Previous Family was disbanded less than a month ago, so a new Family cannot be created at this time.\nPlease try again in {0} days.
plw_family.28	Failed to create a Family.
plw_family.29	The {0} Family has been disbanded. You cannot create another Family for a month.
plw_family.30	Failed to disband Family.\nThe Family does not exist.
plw_family.31	Failed to disband Family.\nOnly the head of household can disband the Family.
plw_family.32	Failed to disband the Family.
plw_family.33	A member was added to the Family.
plw_family.34	The head of household can add a member to the Family.
plw_family.35	The head of household can add a member.
plw_family.36	This character does not exist.
plw_family.37	This character is already in a Family.
plw_family.38	You cannot add a character from the same account as a Family member.
plw_family.39	This character cannot be added as a Family member.
plw_family.40	Failed to add a member to the Family.
plw_family.41	A member was deleted from the Family.
plw_family.42	The head of household can delete a member from the Family.
plw_family.43	The head of household can add a member.
plw_family.44	This character is not in your Family.
plw_family.45	Failed to remove a Family member.
plw_family.46	You left the Family.
plw_family.47	You are not in a Family.
plw_family.48	A parent cannot leave the Family.
plw_family.49	Failed to leave the Family.
plw_family.50	Family tradition has been canceled.\nPlease select a new  family motto.\n
plw_family.51	A new Family tradition has been selected.
plw_family.52	Family tradition can be changed after a minimum of one day.
plw_family.53	Failed to select a Family tradition.
plw_family.54	Requested a summon.
plw_family.55	You cannot request any more summons for today.
plw_family.56	Summon failed.
plw_family.57	Family System\nSummon
plw_family.58	{1} from the {0} Family has requested a summon. Would you like to move?
plw_family.59	The Family name must be at least 4 characters long.
plw_family.60	The family name cannot be more than  20 characters.
plw_family.61	A prohibited character is included.
plw_family.62	Family System\nDisband Family
plw_family.63	If you disband the Family, you will not be able to create a new Family for a month.\nWould you like ti disband the {0} Family?
plw_family.64	Family System\nKick Member
plw_family.65	Would you like to kick {0} from the Family?
plw_family.66	Family System\nLeave Family
plw_family.67	Do you wish to leave the {0} Family?
plw_family.68	Declined the Family join request.
plw_family.69	Someone who left the family in the last 30 days can't be invited as a family member.
plw_family.70	The head of the household can kick out family members.
plw_family.71	The head of the household can add family members.
plw_family.72	Failed to kick out family member.
plw_family.73	A Family Gift was sent to {0}.
plw_family.74	Not enough Family Points.
plw_family.75	Failed to send the Family Gift.
plw_family.76	The Family Remedy effect reduced your level to 1.
plw_family.77	Failed to use the Family Remedy.
plw_family.78	Not enough Family Points.
plw_family.79	Give Family Gift
plw_family.80	Send a Family Gift to {0}?\nThis will cost 5000 Family Points.
plw_family.81	Someone who left the family in the last 7 days can't be invited as a family member.
plw_family.82	Either that person doesn't exist or is in a different channel.
plw_family.83	Unable to create a family.\nTry again in {0} day(s).
plw_family.84	Characters cannot create a family while in the tutorial.
plw_family.85	Characters cannot be invited as members while in the tutorial.
plw_farming.1	Farm Management
plw_farming.2	Your crops need time to grow!\nYou cannot work the field anymore today.
plw_farming.3	You are currently working on {0}.\n You can work on something else in about {0} minute(s).
plw_farming.4	You are not currently on the waiting list. Please get another Waiting Ticket.
plw_farming.5	You have insufficient money in your Inventory.
plw_farming.6	You have insufficient money in the Bank.
plw_farming.7	Your bank account is blocked and cannot be used.
plw_farming.8	Your bank account is locked and cannot be used.
plw_farming.9	There was a problem while managing the Farm.
plw_farming.10	Farm
plw_farming.11	You successfully leased a Farm.
plw_farming.12	Farm
plw_farming.13	Your wait to lease a Farm has ended.
plw_farming.14	Acidity increased by {0}.
plw_farming.15	Acidity decreased by {0}.
plw_farming.16	Acidity didn't change.
plw_farming.17	Purity increased by {0}.
plw_farming.18	Purity decreased by {0}.
plw_farming.19	Purity didn't change.
plw_farming.20	The Oak Barrel was replaced {0} time(s).\n\n{1}\n{2}\nCurrent freshness will be maintained for 24 hours.
plw_farming.21	Replace\nOak Barrel
plw_farming.22	Replace\nOak Barrel
plw_fashiongallery.1	You can't convert to Spectator Mode.
plw_fashiongallery.2	You can't convert to Spectator Mode while the Fashion Contest is in progress.
plw_fashionshowstatueprop.1	Fashion Contest Grand Prize Winner {0}
plw_fashionshowstatueprop.2	Fashion Contest Popularity Prize Winner {0}
plw_fieldquestcomponent.1	Would you like to set up Optimization?\nIf there are a lot of problems with the game's performance, using this function will allow you to play the game more smoothly.
plw_fieldquestcomponent.2	Would you like to restore the existing options?
plw_fieldquestcomponent.3	{0} Point(s)
plw_fieldquestcomponent.4	Field: {0} (Current)\n Total Contributions {1}\n
plw_fieldquestcomponent.5	Time Left: {0}:{1}\n
plw_focuslistencomponent.1	Failed to start Pure Music Mode.\nPlease try again later.
plw_focuslistencomponent.2	You were blocked by the party and cannot switch to Pure Music Mode.
plw_focuslistencomponent.3	Pure Music Mode ended because you are too far away from the party.
plw_focuslistencomponent.4	Failed to end Pure Music Mode.\nPlease try again later.
plw_focuslistencomponent.5	Pure Music Mode ended because the Jam Band broke up.
plw_focuslistencomponent.6	Pure Music Mode ended because you were blocked.
plw_focuslistencomponent.7	The character cannot be found.
plw_focuslistencomponent.8	The party member cannot be blocked.
plw_focuslistencomponent.9	The character cannot be found.
plw_freestylejam.1	{0}: {1} area has received the Blessing of Cairbre.
plw_freestylejamprop.1	{0}'s\nFreestyle Jam
plw_gametipmgr.1	VIP Member, {0}, is entering the world.
plw_gardentreeprop.1	{0}'s Plant
plw_gardentreeprop.2	Messy Plant
plw_guildmgr.1	The design was applied.\nEvery guild member can buy a Robe from Eavan's shop.
plw_guildmgr.2	The guild robe was redesigned.\nYou can purchase the guild robe from the Town Office in Dunbarton.
plw_guildmgr.3	The guild exclusive title was changed to \"{0}\".
plw_hamletsswordprop.1	(Dismount and take a closer look...)
plw_hamletsswordprop.2	You see before you a sword engulfed in flames. Free your hands and you may be able to grab it...
plw_helpboardmgr.1	Failed to register.
plw_helpboardmgr.2	The request has been completed.\nYou can no longer recruit altruists.
plw_helpboardmgr.3	This message was reported for being inappropriate.
plw_helpboardmgr.4	The message has been deleted.
plw_helpboardmgr.5	Someone else has already taken this request.
plw_helpboardmgr.6	You are already in a chat room.\nYou can't enter multiple chat rooms.
plw_helpboardmgr.7	The petitioner does not exist.
plw_helpboardmgr.8	The request was completed successfully.
plw_helpboardmgr.9	Completing a request successfully has yielded you Altruism Points.
plw_helpboardmgr.10	For your exceptional service, you've received additional Altruism Points.
plw_helpboardmgr.11	Mission accomplished.
plw_helpboardmgr.12	Spirit
plw_housecomponentowner.0	This item cannot be sold.
plw_housecomponentowner.1	You cannot open a closet that's currently on sale.
plw_housecomponentowner.2	You cannot open a closet that's currently on sale.
plw_houseguestbook.0	Reading guestbook...
plw_houseguestbook.1	Shop Guestbook
plw_houseguestbook.2	Reading guestbook comments...
plw_houseguestbook.3	Shop Guestbook
plw_houseguestbook.4	Changing greeting...
plw_houseguestbook.5	Shop Guestbook
plw_houseguestbook.6	Adding new post...
plw_houseguestbook.7	Shop Guestbook
plw_houseguestbook.8	Adding comment...
plw_houseguestbook.9	Shop Guestbook
plw_houseguestbook.10	Deleting post...
plw_houseguestbook.11	Shop Guestbook
plw_houseguestbook.12	Shop Guestbook
plw_houseguestbook.13	Your have been temporarily blocked from this guestbook.
plw_houseguestbook.14	Shop Guestbook
plw_houseguestbook.15	Failed to read guestbook.
plw_houseguestbook.16	Shop Guestbook
plw_houseguestbook.17	You have been temporarily blocked from this guestbook.
plw_houseguestbook.18	Shop Guestbook
plw_houseguestbook.19	Failed to read guestbook.
plw_houseguestbook.20	Shop Guestbook
plw_houseguestbook.21	You have been temporarily blocked from this guestbook.
plw_houseguestbook.22	Shop Guestbook
plw_houseguestbook.23	Failed to read guestbook.
plw_houseguestbook.24	Shop Guestbook
plw_houseguestbook.25	Shop Guestbook
plw_houseguestbook.26	Shop Guestbook
plw_houseguestbook.27	Unable to find guestbook window.
plw_houseguestbook.28	Unable to find guestbook window.
plw_houseguestbook.29	Unable to find guestbook window.
plw_housingmgrcache.0	\\Shop
plw_instantgiftcomponent.1	You won the #{0} Ranked Festia Instant Prize!
plw_instantgiftcomponent.2	Thank you for participating in the Festia Instant Prize Event.
plw_instantgiftcomponent.3	You've hit the limit for gold entries for today.
plw_instantgiftcomponent.4	You don't have enough gold to enter the sweepstakes.
plw_instantgiftcomponent.5	You don't have enough tickets to enter the sweepstakes.
plw_instantgiftcomponent.6	Failed to generate the item. Please contact an administrator.
plw_instantgiftcomponent.7	Please try again later.
plw_instantgiftcomponent.8	You won the #{0} Ranked Instant Prize!
plw_instantgiftcomponent.9	Thank you for participating in the Instant Prize Event.
plw_inventory.1	You received {0} Pon.
plw_inventoryaction.0	The location of the Shop will be displayed on the Mini-map.
plw_inventoryaction.1	The Shop is not located in this area.
plw_inventoryaction.2	You cannot view the equipment.
plw_inventoryaction.3	Once you unequip the bag, all items that could not fit in the Inventory will be transferred to the temporary inventory.\nWould you like to remove all the items inside this bag?
plw_inventoryaction.4	Are you sure you want to destroy the {0}? You will lose all the stamps you've collected.
plw_inventoryaction.5	Are you sure you want to destroy the {0}? You will lose all the stamps you've collected.
plw_inventoryaction.6	Not available for use at this time.
plw_inventoryaction.7	Do you wish to exchange the item for points?
plw_inventoryaction.8	You're out of breath! You cannot eat any food or drink any potions.
plw_inventoryaction.9	Cannot be opened because you're not using the Fantasy Life Club.
plw_inventoryaction.10	Failed to restore.
plw_inventoryaction.11	Destroy all?
plw_inventoryaction.12	Please select the untradeable Exclusive Item you want to unlock.\nThe Trade Unlock Potion can be used on the same item up to a maximum of {0} times.\n<color=2>Any Exclusive Items currently equipped will not be displayed.</color>
plw_inventoryaction.13	There are no items to temporarily unlock.
plw_inventoryaction.14	{0} cannot be used at this time.
plw_inventoryaction.15	You must be married to register a Family.
plw_inventoryaction.16	All training has already been completed.
plw_inventoryaction.17	Cannot be used at Rank 1 or above.
plw_inventoryaction.18	Cannot be used. You don't know the corresponding skill.
plw_inventoryaction.19	Notice
plw_inventoryaction.20	That skill's EXP gauge will be completely filled.\nDo you really want to use the item?
plw_inventoryaction.21	%s cannot be used more than once.
plw_inventoryaction.22	Pet cannot be used.
plw_inventoryaction.23	Notice\n
plw_inventoryaction.24	You get a bonus for completing this Shadow Mission.\nDo you want to use it?
plw_inventoryaction.25	{0} cannot be used more than once.
plw_inventoryaction.26	Write a message you want to send to someone on this memo!
plw_inventoryaction.27	Please select the item you wish to remove the expiration on.
plw_inventoryaction.28	Can only be used up to Rank 1.
plw_inventoryaction.29	Avon Feather
plw_inventoryaction.30	Can be re-used.
plw_inventoryaction.31	Teleporting to Avon.
plw_inventoryaction.32	No return location found. You will be teleported to the Avon entrance.
plw_inventoryaction.33	You will be teleported to your previous location.
plw_inventoryaction.34	\nOnce activated, you must wait 5 minutes before you can use this item again.\nTeleport now?
plw_inventoryaction.35	Notice
plw_inventoryaction.36	There are no items in the Kiosk to tidy.
plw_inventoryaction.37	Do you wish to tidy up the items in your Kiosk?\nYour currently open Kiosk will automatically be closed.
plw_inventoryaction.38	Do you wish to tidy up the items in your Kiosk?\nThe items in your Kiosk will be removed,\nand your profits will be deposited into your bank.
plw_inventoryaction.39	Select an item to remove its Artisan Upgrade.
plw_inventoryaction.40	No appropriate items.
plw_inventoryaction.41	Select the Enchant Scroll you want to remove the expiration from.
plw_inventoryaction.42	Avon Feather can be re-used {0}.
plw_inventoryaction.43	{0} is being applied.\nIf you use {0}, the existing effect will disappear.\nWould you like to apply it?
plw_inventoryaction.44	Your stats will increase for a certain amount of time.\nDo you really want to use it?
plw_inventoryaction.45	Would you like to use the {0} item?
plw_inventoryaction.46	Confirm
plw_inventoryaction.47	Select an item to disable exclusivity for.
plw_inventoryaction.48	Select an item to raise the maximum Durability of.
plw_inventoryaction.49	No appropriate items.
plw_inventoryaction.50	You can't destroy a bag with an item in it.
plw_inventoryaction.51	Family Remedy
plw_inventoryaction.52	Drinking this will reduce your level to 1. Proceed?
plw_inventoryaction.53	You get a bonus upon completing a Theatre Mission.\nDo you want to use it now?
plw_inventoryaction.54	Select an item to raise the maximum Durability of.
plw_inventoryaction.55	No appropriate items.
plw_inventoryaction.56	Select an item to raise the Proficiency of.
plw_inventoryaction.57	No appropriate items.
plw_inventoryaction.58	The item was not used properly. Please try again.
plw_inventoryaction.59	Collect the following form?
plw_inventoryaction.60	Notice
plw_inventoryaction.61	The item was not used properly. Please try again.
plw_inventoryaction.62	Would you like to exchange this medal for a coupon?
plw_inventoryaction.63	You already have this form.\nYou can exchange it for a Transformation Medal Coupon instead.\nCollect and use 3 Transformation Medal Coupons for a random Shamala's Transformation Medal.\nProceed with exchange?
plw_inventoryaction.64	You already have this form.
plw_inventoryaction.65	You will receive a bonus upon completing the Iria Raid.\nDo you want to use it now?
plw_inventoryaction.66	Can be used only when Mabinogi VIP Service is in use.
plw_inventoryaction.67	You'll be restricted from using it when the Contribution bonus gets applied.
plw_inventoryaction.68	You will be moved to the region when the Raid begins.\nDo you really want to use it?
plw_inventoryaction.69	Choose an item to repair. ({0}% chance to repair up to {1} Point(s))
plw_inventoryaction.70	That item can only be used on your Homestead.
plw_inventoryaction.71	That item doesn't fit your current theme. You can't place it.
plw_inventoryaction.72	It costs {0} Gold to place that item. Start now?
plw_inventoryaction.73	Notice
plw_inventoryaction.74	If you use the Reward Selection item, the item will disappear.\nWould you like to proceed?
plw_inventoryaction.75	Can be used only when VIP Service is in use.
plw_inventoryaction.76	Confirm
plw_inventoryaction.77	Flying Puppet support deactivated.
plw_inventoryaction.78	Flying Puppet support activated.
plw_inventoryaction.79	Item has expired. Cannot activate.
plw_inventoryaction.80	For beginners only.
plw_inventoryaction.81	Would you like to use {0}?
plw_inventoryaction.82	Soul Essence can only be absorbed when the event is active.
plw_inventoryaction.83	For beginners only.
plw_inventoryaction.84	Bingo Gachapon can only be opened in the Bingo Inventory.
plw_inventoryaction.85	Soul Essence can only be absorbed when the event is active.
plw_inventoryaction.86	어드밴스드 플레이 이상의 서비스를 이용중에만 사용할 수 있습니다.
plw_inventoryaction.87	No items are available for exchange.
plw_inventoryaction.88	Please select the item you wish to exchange.
plw_inventoryaction.89	This pet can't be dyed.
plw_inventoryaction.90	Pets and partner characters cannot use this item.
plw_inventoryaction.91	You are already using a Chat Bubble Sticker. If you use this one, the previous effect will disappear. \nAre you sure you want to use it?
plw_inventoryaction.92	You cannot synthesize activated emblems.
plw_inventoryaction.93	이벤트 기간이 지나면 사용할 수 없습니다.
plw_inventoryaction.94	You can't use that.
plw_inventoryaction.95	You can't use that.
plw_inventoryaction.96	You can't use that.
plw_inventoryaction.97	사용한 아이템은 사라지며 애완동물의 이전 능력치는 사라지고 새로운 능력치를 얻게 됩니다. 진행 하시겠습니까?
plw_inventoryaction.98	RP 진행 중에는 플라잉 퍼핏 서포트 기능을 사용할 수 없습니다.
plw_inventoryaction.99	You don't have any expired items.
plw_inventoryaction.100	You can't put a price on a Check Folio.
plw_inventoryaction.102	Choose a Music Score to put inside the Music Box.
plw_inventoryaction.103	You cannot play Rock Paper Scissors while playing a Festia mini-game or attraction.
plw_inventoryaction.104	You can't do that right now.
plw_inventoryaction.105	There are no items that can be swapped.
plw_inventoryaction.106	No items available to select.
plw_inventoryaction.107	봉인된 아이템은 파기할 수 없습니다.
plw_inventoryaction.108	악보가 들어있는 오르골은 가격을 설정할 수 없습니다.
plw_inventoryaction.109	Your hair is already dyed that color.
plw_inventoryaction.110	You cannot dye this hair.
plw_inventoryaction.111	장비 교체 키트를 넣을 인벤토리의 공간이 부족합니다.
plw_inventoryaction.112	Please select a Doll Bag to put in the chest.
plw_inventoryaction.113	You can't use a Beauty Hair Storage Coupon right now.
plw_inventoryaction.114	Only usable on a hairstyle that came from a Beauty Coupon.
plw_inventoryaction.115	Your current hairdo and hair color will be stored as a coupon in case you want to revert to them later. Storing them will shift your hair to its basic appearance.
plw_inventoryaction.116	You can't use a Hairstyle Storage Coupon right now.
plw_inventoryaction.117	Your current hairdo and hair color will be stored as a coupon in case you want to revert to them later. Storing them will shift your hair to its basic appearance.\n\nWould you like to store your current hairdo and hair color as a coupon?
plw_inventoryaction.119	You don't have an Echostone to supplement.
plw_inventoryaction.120	Select an Echostone to supplement.
plw_inventoryaction.121	EXP bonus will be applied when you defeat the selected Shadow Mission's monsters. Are you sure you want to use it?
plw_inventoryaction.122	You cannot use a Mission AutoVictory Coupon while in a party.
plw_inventoryaction.123	There is no Elite Mission Pass in the inventory.
plw_inventoryaction.124	You cannot use a Mission AutoVictory Coupon while in a party.
plw_inventoryaction.125	There is no Theatre Mission Pass in the inventory.
plw_inventoryaction.126	Would you like to use the {0}?
plw_inventoryaction.127	The potion is currently in effect.
plw_inventoryaction.128	You've already drunk a Meditation Potion that granted you serenity, albeit not one as deep as the serenity this potion will grant you!\nStill, the first potion's effect will disappear if you now drink the {0}.\nWould you like to drink it anyway?
plw_inventoryaction.129	\nThe EXP collected in the Empty Prism will be deleted.
plw_inventoryaction.130	You can't destroy an item when the Prism Collection window is open.
plw_inventoryaction.131	\nIf you store it in inventory, the pouch will be removed from the bag.
plw_inventoryaction.132	You can't use this here.
plw_inventoryaction.133	Would you like to use the item and install {0}?
plw_inventoryaction.134	You can't do that right now.
plw_inventoryaction.135	Select the item for which you wish to increase Trade Unlocks.\nCan only be used on personalized items and can only be applied once per item.\n<color=2>Items that are currently equipped and items that have the maximum number of Trade Unlocks will not be marked.</color>
plw_inventoryaction.136	There is no item for which you can increase Trade Unlocks.
plw_inventoryaction.137	This Eidos does not require recharging.
plw_inventoryaction.138	Cannot be used while you're in a party.
plw_inventoryaction.139	You can't use that right now.
plw_inventoryaction.140	Cannot be used while mounted on a pet.
plw_inventoryaction.141	Confirm
plw_inventoryaction.142	Lorna's Growth Support is currently in use.\nThe effects of Lorna's Growth Support and Constellation Balloons will not stack,\nand the higher values between the two will be applied.\nDo you really want to use it now?
plw_inventoryaction.143	The charm is already active.
plw_inventoryaction.144	Confirm
plw_inventoryaction.145	The Pisces effect is currently active.\nThe effects of Pisces and Lorna's Growth Support wil not stack,\nand the higher values between the two will be applied.\nDo you really want to use it now?
plw_inventoryaction.146	If you use the orb now, you will lose any briogh that exceeded the maximum amount allowed.\nDo you still want to use the item?
plw_inventoryaction.147	The width of the Basic, Me, and VIP inventory tabs will be increased by 1 row, expanding\nyour inventory from a size of <color=5>[{0}x{1}]</color> to <color=5>[{2}x{3}]</color>.\n\nWould you like to expand your inventory?\n
plw_inventoryaction.148	You've expanded your inventory a total of <color=5>{0}</color> times.\nYou cannot expand your inventory further.
plw_inventoryaction.149	You can manage crystals once every 60 seconds.
plw_inventoryaction.150	{0} 효과가 적용중입니다.\n{1} 효과와 로나의 성장 지원 효과는 중첩되지 않으며,\n{2} 효과와 로나의 성장 지원 효과 중 최대 높은 값이 적용됩니다.\n사용하시겠습니까?
plw_inventoryaction.151	Inventory expansion failed. \nPlease use an <color=5>Inventory Expansion Coupon PLUS</color> to expand your inventory more.
plw_inventoryaction.152	Inventory expansion failed. \nYou can only use this after you've already expanded your inventory\nwith a regular Inventory Expansion Coupon {0} times.
plw_inventoryaction.153	There's no spirit to inherit the memory from.
plw_inventoryaction.155	\nThe Spirit Weapon will not be unbound.
plw_inventoryaction.156	눈 스타일 회수 쿠폰을 사용할 수 없는 상태입니다.
plw_inventoryaction.157	현재 적용 중인 눈 컬러와 스타일이 쿠폰으로 보관되고, 기본 눈 스타일로 변경됩니다.\n현재 눈을 쿠폰으로 변경하시겠습니까?
plw_inventoryaction.158	The Exclusive Pet Pouch can only be used when you have a pet summoned.
plw_inventoryaction.159	Partners can't use this item.
plw_inventoryaction.160	An Exclusive Pet Pouch has already been applied to this pet.\nOnly one Exclusive Pet Pouch may be applied per pet.
plw_inventoryaction.161	Can be used after {0}.
plw_inventoryaction.162	An object is already installed.\nInstall again after removing it?
plw_inventoryaction.163	Cannot be used during commerce.
plw_inventoryaction.164	Cannot be used while mounted.
plw_inventoryaction.165	Cannot be used while using a skill.
plw_inventoryaction.166	Cannot be used while seated.
plw_inventoryaction.167	You cannot use this with a pet summoned.\nTry again after de-summoning your pet.
plw_inventoryaction.172	Select an Exclusive Enchant Scroll that you want to make tradable.
plw_inventoryaction.173	[세트 효과 {0}] +[{1}] 업그레이드를 부여할 아이템을 선택하세요.
plw_inventoryaction.174	세트 효과 업그레이드
plw_inventoryvmmessage.0	You may share your food amongst the people that are sitting in chairs.\nYou can share everyone's food 50/50.\nWould you like to do a House Share?
plw_inventoryvmmessage.1	House Sharing
plw_inventoryvmmessage.2	Unable to receive this item.
plw_inventoryvmmessage.3	Send Rice Cake
plw_inventoryvmmessage.4	On New Year's Day, it is customary to show people you care about them by sending Rice Cakes.\nWould you like to use the Rice Cake Delivery service?\n(If you would rather just eat the Rice Cake yourself, select 'No')
plw_inventoryvmmessage.5	Send White Chocolate
plw_inventoryvmmessage.6	On White Day, it is customary to show people you care about them by sending White Chocolate.\nWould you like to use the White Chocolate Delivery service?\n(If you would rather just eat the chocolate yourself, select 'No')
plw_inventoryvmmessage.7	Send Marshmallow
plw_inventoryvmmessage.8	On White Day, it is customary to show people you care about them by sending Marshmallows.\nWould you like to use the Marshmallow Delivery service?\n(If you would rather just eat it yourself, select 'No')
plw_inventoryvmmessage.9	Yes
plw_inventoryvmmessage.10	No
plw_inventoryvmmessage.11	You can share your food with others.\nRegardless of how many people you share it with, everyone will receive 50% evenly.\nDo you wish to do Food Sharing?
plw_inventoryvmmessage.12	Food Sharing
plw_inventoryvmmessage.13	You are attempting to open the Ordinary Chest using the Premium Chest Key.\nAre you sure you want to proceed?
plw_inventoryvmmessage.14	Open the Ordinary Chest
plw_inventoryvmmessage.15	Send Moon Cake
plw_inventoryvmmessage.16	On Thanksgivings Day, it is customary to show people you care about them by sending Moon Cakes.\nWould you like to use the Moon Cake Delivery service?\n(If you would rather just eat it yourself, select 'No')
plw_inventoryvmmessage.17	{0} dropped.
plw_inventoryvmmessage.18	The item has been dropped.
plw_inventoryvmmessage.19	Failed to destory all.
plw_inventoryvmmessage.20	You can eat with other people that are sitting around the campfire.\nEating with others will maintain the positive effects longer.\nWant to share a campfire?
plw_inventoryvmmessage.21	Restore the Artisan Upgrade?
plw_inventoryvmmessage.22	You must delete an unused Combo Card from the Combo Card Inventory.
plw_inventoryvmmessage.23	Refused to Fish together.
plw_inventoryvmmessage.24	Select an item to use as a bait.
plw_inventoryvmmessage.25	You must learn the Fishing skill to use it.
plw_inventoryvmmessage.26	Failed to configure Tag settings on the Bag.
plw_inventoryvmmessage.27	This upgrade can only be applied once.\nProceed with upgrade?
plw_inventoryvmmessage.28	{0}'s extended by {1} day(s).\nYou have {2} Pon left.
plw_inventoryvmmessage.29	The totem has been activated.
plw_inventoryvmmessage.30	This totem cannot be activated because another totem of the same type is already activated.
plw_inventoryvmmessage.31	The totem has been deactivated.
plw_inventoryvmmessage.32	An error occurred during the process.
plw_inventoryvmmessage.33	This totem will be deactivated because another totem of the same type has already been activated.
plw_inventoryvmmessage.34	Totems cannot be activated from an animal's inventory.
plw_inventoryvmmessage.35	The totem cannot be changed while in combat.
plw_inventoryvmmessage.36	예기치 못한 오류로 아이템 삭제를 실패하였습니다.
plw_inventoryvmmessage.37	You don't have enough inventory space to receive the item.
plw_inventoryvmmessage.38	You cannot create a Guild right now.
plw_inventoryvmmessage.39	{0}{은} 삭제가 불가능한 아이템 입니다.
plw_inventoryvmmessage.40	That item can't be used.
plw_inventoryvmmessage.41	해당 아이템 수량이 부족합니다.
plw_inventoryvmmessage.42	10회 사용을 할 수 없습니다.\n가챠폰 인벤토리를 정리해주세요
plw_inventoryvmmessage.43	This doesn't seem to be the right item...
plw_inventoryvmmessage.44	This doesn't seem to be the right item...
plw_inventoryvmmessage.45	You can only have one Mini-gem summon active at a time.
plw_inventoryvmmessage.46	You need to wait a moment before you resummon.
plw_inventoryvmmessage.47	You can't seem to summon here.
plw_inventoryvmmessage.48	You cannot bring it to Erinn for some unforeseen reason.
plw_inventoryvmmessage.49	This guy has no brain.
plw_inventoryvmmessage.50	Cannot summon now.
plw_inventoryvmmessage.51	This item isn't working properly.
plw_inventoryvmmessage.52	Stance activated.
plw_inventoryvmmessage.53	Stance deactivated.
plw_inventoryvmmessage.54	The item has expired and cannot be activated.
plw_inventoryvmmessage.55	The totem has expired and will be deactivated.
plw_inventoryvmmessage.56	{0}'s {1} increased by {2}.
plw_inventoryvmmessage.57	{0}: Level {1}\n
plw_inventoryvmmessage.58	{0} completed.\n{1}
plw_inventoryvmmessage.59	The item cannot be added because you have no space.
plw_inventoryvmmessage.60	Emblem synthesis results:\n
plw_inventoryvmmessage.61	{0}: Level {1}\n
plw_inventoryvmmessage.62	Emblem synthesis failed.\nThe emblem has been destroyed.
plw_inventoryvmmessage.63	You cannot synthesize this emblem any further.
plw_inventoryvmmessage.64	You cannot synthesize activated emblems.
plw_inventoryvmmessage.65	You cannot activate a broken totem.
plw_inventoryvmmessage.66	You cannot activate an expired totem.
plw_inventoryvmmessage.67	You cannot activate the totem.\nPlease check the item's race restrictions.
plw_inventoryvmmessage.68	You cannot activate the totem.\nPlease check the item's age restrictions.
plw_inventoryvmmessage.69	You cannot activate the totem.\nPlease check the item's skill restrictions.
plw_inventoryvmmessage.70	Cannot activate the totem.\nPlease check the item's talent restrictions.
plw_inventoryvmmessage.71	You couldn't activate the totem.
plw_inventoryvmmessage.72	You couldn't deactivate the totem.
plw_inventoryvmmessage.73	You cannot activate a stance with a broken item.
plw_inventoryvmmessage.74	You cannot activate a stance with an expired item.
plw_inventoryvmmessage.75	You cannot activate this stance.\nPlease check the item's race restrictions.
plw_inventoryvmmessage.76	You cannot activate this stance.\nPlease check the item's age restrictions.
plw_inventoryvmmessage.77	You cannot activate this stance.\nPlease check the item's skill restrictions.
plw_inventoryvmmessage.78	You cannot activate this stance.\nPlease check the item's talent restrictions.
plw_inventoryvmmessage.79	You couldn't activate the stance.
plw_inventoryvmmessage.80	You couldn't deactivate the stance.
plw_inventoryvmmessage.81	You can only select an empty bag.
plw_inventoryvmmessage.82	[{0}]\nReward: {1} EXP and {2} Gold\nIf you use this coupon and you don't have enough room in your inventory or gold pouch for all of the reward gold, any surplus will be dropped on the ground.\nDo you still want to use the Mission AutoVictory Coupon?
plw_inventoryvmmessage.83	Reward: {0} EXP and {1} Gold
plw_inventoryvmmessage.84	Can only be activated in the pet inventory window.
plw_inventoryvmmessage.85	Conversion has failed.
plw_inventoryvmmessage.86	The bag you selected has a pouch tied to it.\nRemove the pouch and store it in the inventory?
plw_inventoryvmmessage.87	Regular enhancement succeeded! {0} increased by {1}.
plw_inventoryvmmessage.88	Regular enhancement greatly succeeded! {0} increased by {1}.
plw_inventoryvmmessage.89	Secondary enhancement succeeded! {0} increased by {1}.
plw_inventoryvmmessage.90	Secondary enhancement succeeded! {0} increased to max.
plw_inventoryvmmessage.91	Enhancement failed.
plw_inventoryvmmessage.92	Cannot enhance.
plw_inventoryvmmessage.93	Your doll bags are now collecting items.
plw_inventoryvmmessage.94	Your doll bags are no longer collecting items.
plw_inventoryvmmessage.95	An unknown error has occurred. Error: 1
plw_inventoryvmmessage.96	An unknown error has occurred. Error: 2
plw_inventoryvmmessage.97	The Additional Stat Stones have further increased your stats by {0}.
plw_inventoryvmmessage.98	The amulet gained the Additional Stat Stone's power.\nAmulet enhancement will increase the stat effects by {0}.
plw_inventoryvmmessage.99	Your inventory has been expanded to the dimensions <color=5>[{0}x{1}]</color>.
plw_inventoryvmmessage.100	Use 1 {0} to expand your inventory?
plw_inventoryvmmessage.101	Emblem synthesis failed.
plw_inventoryvmmessage.102	선택한 아이템은 인챈트가 적용 되어 있습니다.\n현재 아이템의 인챈트 정보를 보존하여 교환하시겠습니까?
plw_inventoryvmmessage.103	This totem can't be activated in your current pet's inventory window.
plw_inventoryvmmessage.104	Failed to expand the summoned pet's inventory size.
plw_inventoryvmmessage.105	Successfully expanded the summoned pet's inventory size.
plw_inventoryvmmessage.106	Are you sure you want to convert so that\nthe pertinent Exclusive Enchant can be made tradable?
plw_inventoryvmmessage.107	인형 가방의 골드 수집 기능이 활성화 되었습니다.
plw_inventoryvmmessage.108	인형 가방의 골드 수집 기능이 비활성화 되었습니다.
plw_item.0	Increased assault damage in ranged attacks
plw_item.1	Decreased assault damage in ranged attacks
plw_item.2	Increased assault distance in ranged attacks
plw_item.3	Decreased assault distance in ranged attacks
plw_item.4	Increased assault angle in ranged attacks
plw_item.5	Decreased assault angle in ranged attacks
plw_item.9	Male Elf Only
plw_item.10	Female Elf Only
plw_item.11	Elf Only
plw_item.12	Male Human Only
plw_item.13	Female Human Only
plw_item.14	Human
plw_item.15	Elf
plw_item.16	Giant
plw_item.17	Male
plw_item.18	Female
plw_item.19	-only
plw_item.20	Activate Chain Casting +{0}
plw_item.21	MP Usage +{0}%
plw_item.22	MP Usage -{0}%
plw_item.23	Evaporated MP -{0}%
plw_item.24	Skill Requirement : Rank {0} {1} or higher
plw_item.25	Skill Requirement : {0} Dan {1} or higher
plw_item.26	Upgrade {0}/{1}\nGem Upgrade {2}
plw_item.27	- {0}% Charging Speed
plw_item.28	+ {0}% Charging Speed
plw_item.29	Magic ATT -{0}
plw_item.30	Magic ATT +{0}
plw_item.31	\n\n<color=2> While calling the dragon (Not Available)</color>
plw_item.32	\n\n<color=2>Not Available</color>
plw_item.33	Blessed 
plw_item.34	Royal Alchemist Only
plw_item.35	\n{0} Exclusive Item (Trade Unlock)
plw_item.36	<color=0>Number of unlocks available : {0}</color>
plw_item.37	<color=2>Number of unlocks available : 0</color>
plw_item.38	Holy
plw_item.39	\n\n{0}/5 times
plw_item.40	AP +{0}
plw_item.41	Ice Magic Damage +15%
plw_item.42	When raining, Attack -50%
plw_item.43	Max Durability +{0}\n
plw_item.44	Max Durability -{0}\n
plw_item.45	An artisan has upgraded {0} \nto {1}.
plw_item.46	<color=3>Piercing Level {0}\n(Decreases Defense by {1} and Protection by {2})</color>
plw_item.47	<color=3>Piercing Level {0}</color> <color=5>+{1}</color>\n<color=3>(Decreases Defense by {2} and Protection by {3})</color>
plw_item.48	Defense +{0}
plw_item.49	Protection +{0}
plw_item.50	Protection -{0}
plw_item.51	Attack <color=3>{0}</color><color=4>({1})~<color=3>{2}</color><color=4>({3})</color>
plw_item.52	<color=4>A [Prefix] enchant has not been applied. You can use an [Enchant Scroll] to apply enchants.</color>
plw_item.53	<color=4>A [Suffix] enchant has not been applied. You can use an [Enchant Scroll] to apply enchants.</color>
plw_item.54	Normal Upgrade
plw_item.55	Normal Upgrade
plw_item.56	<color=4>Depending on the item, you can upgrade your equipment up to </color> <color=0>{0} times</color> <color=4> at the [Blacksmith's Shop], [Weapons Shop], [Clothing Shop], etc.</color>
plw_item.57	Artisan Upgrade
plw_item.58	Special Upgrade
plw_item.59	Special Upgrade
plw_item.60	<color=4>You can upgrade by using a Blue Upgrade Stone or a Red Upgrade Stone at the Upgrade Anvil.</color>
plw_item.61	{0}{1} Rank </color>
plw_item.62	<color=4>You can reforge an equipment by using an [Equipment Reforging Tool]. When you reforge an item, [Reforge Stats] will be applied to it.</color>
plw_item.63	Item Description
plw_item.64	Item Attributes
plw_item.65	Enchant
plw_item.66	Upgrade
plw_item.67	Reforging
plw_item.68	Seasoning Effect
plw_item.69	Set Item
plw_item.70	{0} Only
plw_item.71	Decrease Mana Consumption 
plw_item.72	Charging Speed
plw_item.73	+{0}%
plw_item.74	Magic Attack
plw_item.75	+{0}
plw_item.76	Critical Damage
plw_item.77	+{0}%
plw_item.78	-{0}% Critical Damage
plw_item.79	Fire Alchemy Enhancement
plw_item.80	+{0}%
plw_item.81	-{0}% Fire Alchemy Enhancement
plw_item.82	Earth Alchemy Enhancement 
plw_item.83	+{0}%
plw_item.84	-{0}% Earth Alchemy Enhancement
plw_item.85	Wind Alchemy Enhancement
plw_item.86	+{0}%
plw_item.87	-{0}% Wind Alchemy Enhancement
plw_item.88	Water Alchemy Enhancement
plw_item.89	+{0}%
plw_item.90	-{0}% Water Alchemy Enhancement
plw_item.91	Talent Requirement: {0} or higher
plw_item.92	Music Buff Effect +{0}
plw_item.93	Music Buff Duration +{0} Sec
plw_item.94	<color=4>A [Prefix] enchant has not been applied. You can use an [Enchant Scroll] to apply enchants. Usable [Enchant Scrolls]:</color>\n
plw_item.95	<color=4>A [Suffix] enchant has not been applied. You can use an [Enchant Scroll] to apply enchants. Usable [Enchant Scrolls]:</color>\n
plw_item.96	<color=4>  - {0}</color>\n
plw_item.98	{0} {1}
plw_item.107	+{0}
plw_item.108	Bullet {0}/{1}
plw_item.109	Ducats increase : {0}
plw_item.110	{0}/30 eggs
plw_item.111	Magic Defense {0}\n
plw_item.112	Magic Protection {0}\n
plw_item.113	{0} Skill EXP +{1}%
plw_item.114	Equipped\n
plw_item.115	{0} LV {1} (+{2})\n
plw_item.116	Training Points +{0}
plw_item.117	Partner
plw_item.118	Increases Movement Speed by {0}%
plw_item.119	\n파기하면 무기에 깃든 정령도 함께 사라집니다.
plw_itemenhancemgr.1	<color=3>[Special Upgrade: </color><color=7>{0}</color><color=3> Level]</color>\n
plw_itemenhancemgr.2	The Special Upgrade could not be performed.
plw_itemenhancemgr.3	Notice
plw_itemenhancemgr.4	Equip the item?
plw_itemenhancemgr.5	<color=7>{0}</color><color=3>Step</color>\n
plw_itemergenhancemgr.1	\n<color=5>EXP Infused: {0}</color>
plw_itemergenhancemgr.2	Level: {0}\nMax Level: {1}\nEXP: {2}/{3}\n
plw_itemergenhancemgr.3	\nBasic Effect\n<color=3>{0}</color>\n
plw_itemergenhancemgr.4	\nBonus Effect\n<color=3>{0}</color>
plw_itemmarket.1	유효하지 않은 사용자 입니다.
plw_itemmarket.2	이미 인벤토리로 이동된 아이템입니다.
plw_itemmarket.3	판매 금지된 아이템입니다.
plw_itemmarket.4	아이템 오픈마캣 보관함이 가득 찼습니다.
plw_itemmarket.5	유효하지 않은 판매자 입니다.
plw_itemmarket.6	이미 판매된 아이템입니다.
plw_itemmarket.7	판매 취소된 아이템입니다.
plw_itemmarket.8	잔액이 부족합니다.
plw_itemmarket.9	판매 금지된 아이템입니다.
plw_itemmarket.10	아이템 오픈마캣 보관함 작업에 실패하였습니다.
plw_itemmarket.11	아이템 오픈마캣 보관함 작업에 실패하였습니다.\n오류 코드 : %I64u
plw_itemmarket.12	아이템 오픈마캣 작업에 실패하였습니다.
plw_itemmarket.13	아이템 오픈마캣을 작업에 실패하였습니다.\n오류 코드 : %I64u
plw_itemmarket.14	로딩 중입니다.
plw_itemmarket.15	아이템 오픈 마켓
plw_itemmarket.16	아이템 오픈마켓
plw_itemmarket.17	수수료가 {0} Gold 부족합니다.
plw_itemmarket.18	구매중 오류가 발생했습니다.
plw_itemtooltip.0	District: 
plw_itemtooltip.1	Address: 
plw_itemtooltip.2	Your Bid: 
plw_itemtooltip.3	Auction Ends: {2}:{3} on {0}/{1}
plw_itemtooltip.4	Slightly increased collection speed
plw_itemtooltip.5	Increased collection speed
plw_itemtooltip.6	Increased collection probability
plw_itemtooltip.7	Can collect 2 items at a time within a set probability
plw_itemtooltip.8	Increased repair fee
plw_itemtooltip.9	'{0}'\n\n칠월 칠석에\n{1}{이} {2}에게
plw_itemtooltip.10	Glowing {0}
plw_itemtooltip.11	\n\nExpires in {2}:00, {0}/{1}
plw_itemtooltip.12	Valid until {0}/{1}
plw_itemtooltip.13	Valid until {2}:00, {0}/{1}
plw_itemtooltip.14	For Cooking Contests Only
plw_itemtooltip.15	{0}'s work of art
plw_itemtooltip.16	Repair Fee x {0}.{1}
plw_itemtooltip.17	Repair Fee x {0}
plw_itemtooltip.18	총 물 준 횟수 %d번
plw_itemtooltip.19	<color=3>{0} Seal</color>
plw_itemtooltip.20	Times Watered: {0}
plw_itemtooltip.21	QUAL: {0}
plw_itemtooltip.22	Charge Count: {0}
plw_itemtooltip.23	(Item protected if repair results in failure)
plw_itemtooltip.24	(Item protected if Enchant results in failure)
plw_itemtooltip.25	The item has been sealed.
plw_itemtooltip.26	The seal expires in {0} hr {1} min.
plw_itemtooltip.27	The seal expires in less than 5 minutes.
plw_itemtooltip.28	The seal expires in {0} min.
plw_itemtooltip.29	There is a recorded video.
plw_itemtooltip.30	Title:
plw_itemtooltip.31	You can record a video.
plw_itemtooltip.32	Only Pet Trade Possible
plw_itemtooltip.33	\nCreator : {0}\nAged: {1} Day(s)\nClient: {2}
plw_itemtooltip.34	Number of times the Owl has been fed: {0} times
plw_itemtooltip.35	\nOver {0} {1}
plw_itemtooltip.36	\n\nLucky Coupon Number : <color=1>{0}</color>
plw_itemtooltip.37	\n\n<color=2>This is not a valid Lucky Coupon.</color>
plw_itemtooltip.38	Slope {0}
plw_itemtooltip.39	\n\n<color=7>You may be able to use this more efficiently if you talk to the alchemist who invented the Tower Cylinder.</color>
plw_itemtooltip.40	None
plw_itemtooltip.41	\n목적지:[<color=3>{0}<color=0>]
plw_itemtooltip.42	(인챈트 불가)
plw_itemtooltip.43	\n{0}까지 부활 가능
plw_itemtooltip.44	Revive Unavailable
plw_itemtooltip.45	[When your Destiny is: {0}]
plw_itemtooltip.46	Available</color>
plw_itemtooltip.47	\n\n<color=3>Available</color>
plw_itemtooltip.48	\n<color=3>Return Location: {0}</color>
plw_itemtooltip.49	Defense
plw_itemtooltip.50	Protection
plw_itemtooltip.51	Minimum Damage
plw_itemtooltip.52	Maximum Damage
plw_itemtooltip.53	Critical
plw_itemtooltip.54	Magic Attack
plw_itemtooltip.55	Fire Alchemy Efficiency
plw_itemtooltip.56	Wind Alchemy Efficiency
plw_itemtooltip.57	Earth Alchemy Efficiency
plw_itemtooltip.58	Water Alchemy Efficiency
plw_itemtooltip.59	[When your Destiny is: {0}]
plw_itemtooltip.60	+{0}
plw_itemtooltip.61	{0} {1}
plw_itemtooltip.62	<color=3>This product includes\nitems like the following.</color>
plw_itemtooltip.63	({0})
plw_itemtooltip.64	[Artisan Upgrade]
plw_itemtooltip.65	Max Durability +{0}
plw_itemtooltip.66	Min Durability -{0}
plw_itemtooltip.67	Pet Adoption Info\nAdoption count: {0} / {1}\nRace: {2}\nAge : {3}\nLevel: {4} (Cumulative Level: {5})
plw_itemtooltip.68	\n\n<color={0}>Allowable trades left: {1}</color>
plw_itemtooltip.69	Collect: 
plw_itemtooltip.70	Fishing Journal
plw_itemtooltip.71	Cooking Journal
plw_itemtooltip.72	Taming Journal
plw_itemtooltip.73	{0}Max Damage +{1}
plw_itemtooltip.74	{0}Magic ATT +{1}
plw_itemtooltip.75	{0}Critical +{1}%
plw_itemtooltip.76	When equipped with {0}
plw_itemtooltip.77	\nMP Usage -{0}%
plw_itemtooltip.78	\nMax MP +{0}
plw_itemtooltip.79	\nEvaporated MP -{0}%
plw_itemtooltip.80	Can be stored in Quest Inventory.
plw_itemtooltip.81	Can be stored in Special Inventory.
plw_itemtooltip.82	Wait Time: {0}
plw_itemtooltip.83	Master
plw_itemtooltip.84	Seal Expiration {0}
plw_itemtooltip.85	\nDuration: {0}
plw_itemtooltip.86	(Protects abilities during Spirit Transfer)
plw_itemtooltip.87	This Bag currently has the
plw_itemtooltip.88	Tag.
plw_itemtooltip.89	이 아이템은 정해진 장소에서만 사용할 수 있습니다.\n발급 지역 : [<color=3>{0}<color=0>]
plw_itemtooltip.90	\n+{0}% MP Recovery Rate
plw_itemtooltip.91	Ducats: {0} D
plw_itemtooltip.92	<color=3>size : {0}cm</color>
plw_itemtooltip.93	<color=3>Passes: {0}</color>
plw_itemtooltip.94	<color=3>{0} successes</color>
plw_itemtooltip.95	\nRevivals Left: {0}
plw_itemtooltip.96	Price: {0:Pawn_Price} Pon
plw_itemtooltip.97	Expires In: {0:Day_Limit} days
plw_itemtooltip.98	Valid until {1}/{2}/{0}
plw_itemtooltip.99	Expired
plw_itemtooltip.100	Rate +{0}%
plw_itemtooltip.101	\n\n<color=3>NPC: {0}</color>
plw_itemtooltip.102	\n\n<color=3>Monster: {0}</color>
plw_itemtooltip.103	until {1}/{2}/{0} at {3}:{4}
plw_itemtooltip.104	Name: {0}
plw_itemtooltip.105	<Please name it.>
plw_itemtooltip.106	Unlimited
plw_itemtooltip.107	Expired.
plw_itemtooltip.108	Remaining Summon Time: {0}
plw_itemtooltip.109	<color=3>Completeness : {0}%</color>
plw_itemtooltip.110	\nFleta Repair
plw_itemtooltip.111	\nMagic School Repair
plw_itemtooltip.112	\nGeneral Shop Repair
plw_itemtooltip.113	\nBlacksmith Repair
plw_itemtooltip.114	\nTrading Post Repair
plw_itemtooltip.115	\nEngineer Repair
plw_itemtooltip.116	\nFleta Repair
plw_itemtooltip.117	\nBangor Pub Repair
plw_itemtooltip.118	\nClothing Shop Repair
plw_itemtooltip.119	\nAlchemist Repair
plw_itemtooltip.120	Deactivated
plw_itemtooltip.121	Expires
plw_itemtooltip.122	Remaining Activation Time: {0}
plw_itemtooltip.123	\n플레타 수리
plw_itemtooltip.124	\nNew Appearance\n
plw_itemtooltip.125	Human
plw_itemtooltip.126	Elf
plw_itemtooltip.127	Giant
plw_itemtooltip.128	Partner
plw_itemtooltip.129	\nAvailable Races\n
plw_itemtooltip.130	Effects cannot be applied right now.
plw_itemtooltip.131	Summoning...
plw_itemtooltip.132	Duration: {0} hr
plw_itemtooltip.133	Appearance Change Item: {0}\(Not tradable)
plw_itemtooltip.134	획득시 전용화
plw_itemtooltip.135	\n획득시 전용화되는 아이템
plw_itemtooltip.136	Summons remaining:
plw_itemtooltip.137	Original Copy
plw_itemtooltip.138	First Draft
plw_itemtooltip.139	Edition {0}
plw_itemtooltip.140	Total Amount In Check Folio
plw_itemtooltip.141	\n\nAcquired EXP upon use : {0}
plw_itemtooltip.142	(Containing Items Inside)
plw_itemtooltip.143	(Unable to Auto-Destroy)
plw_itemtooltip.144	Remaining Fruit: {0}
plw_itemtooltip.145	Can be used now
plw_itemtooltip.146	Can be used in {0}
plw_itemtooltip.147	Awakened Abilities
plw_itemtooltip.148	<color=3>No current awakened stats</color>
plw_itemtooltip.149	\nDoll Bag Information\nType : {0}\nProvides : {1} * {2}\n
plw_itemtooltip.150	Store {0} (for {1})
plw_itemtooltip.151	\nStore the color {0}
plw_itemtooltip.152	\nUsable when rank is within {0} - {1}\n
plw_itemtooltip.153	Loving Bond
plw_itemtooltip.154	Your Sweetheart: \"{0}\"
plw_itemtooltip.155	Additional Options
plw_itemtooltip.156	Regular enhancements remaining
plw_itemtooltip.157	Secondary enhancements remaining
plw_itemtooltip.158	's Homestead
plw_itemtooltip.159	Erg
plw_itemtooltip.160	Original
plw_itemtooltip.161	Shop Purchase
plw_itemtooltip.162	<color=2>The Trade Unlock Letter of Guarantee cannot be used</color>
plw_itemtooltip.163	Shop Sales Bonus: 
plw_itemtooltip.164	EXP {0}
plw_itemtooltip.165	EXP {0}%
plw_itemtooltip.166	Exploration EXP {0}
plw_itemtooltip.167	Exploration EXP {0}%
plw_itemtooltip.168	Appearance Change Item: {0}
plw_itemtooltip.169	Briogh of Achievement {0}/{1}
plw_itemtooltip.170	Briogh of Challenge {0}/{1}
plw_itemtooltip.171	Briogh of Discipline {0}/{1}
plw_itemtooltip.172	Additional Stat Stone (Regular) is active.
plw_itemtooltip.173	Additional Stat Stone (Secondary) is active.
plw_itemtooltip.174	{0} LV {1} (+{2}{3})\n
plw_itemtooltip.175	Chain Cylinder Cooldown -{0} sec
plw_itemtooltip.176	Control Marionette Range +{0}
plw_itemtooltip.177	{0}% chance to revive upon Marionette death
plw_itemtooltip.178	Combo Damage +{0}%
plw_itemtooltip.179	Combo: Drop Kick Splash Range +{0}%
plw_itemtooltip.180	Pummel Damage +{0}%
plw_itemtooltip.181	Will +{0}
plw_itemtooltip.182	Alchemy Crystal Storage
plw_itemtooltip.183	Applied Interaction: {0}
plw_itemtooltip.184	\nPet Points: {0}
plw_itemtooltip.185	\nSpecialized Perk: 
plw_itemtooltip.186	\nCurrent Perk: 
plw_itemtooltip.187	\nBase Stats : HP {0}, MP {1}, Stamina {2}, Strength {3}, Intelligence {4}, Dexterity {5}, Will {6}, Luck {7}
plw_itemtooltip.188	{0} {1}
plw_itemtooltip.189	{0} {1}-hit {2}
plw_itemtooltip.190	\n\n - Rental Date: {1}/{2}/{0}\n - Rental Time: {3} o'clock - {4} o'clock\n - Rental Cost: {5} Gold\n - Concert Invite Purchase Cost: {6} Gold
plw_itemtooltip.191	\n\n - Concert Host: {0}\n - Concert Date: {2}/{3}/{1}\n - Concert Start Time: {4} o'clock
plw_itemtooltip.192	\n\n - No. {0}\n - Concert Host: {1}\n - Concert Date: {3}/{4}/{2}\n - Concert Start {5} o'clock
plw_itemtooltip.193	Spirit
plw_itemtooltip.194	{1} of {0}
plw_itemtooltip.195	Level {0}
plw_itemtooltip.196	EXP {0} ({1}%)
plw_itemtooltip.197	Spirit Bond {0}/{1}
plw_itemtooltip.198	EP {0}/{1}
plw_itemtooltip.201	\nInheritable EXP: {0}
plw_itemtooltip.202	\n왼쪽: {0}, 오른쪽: {1} 컬러 보관
plw_itemtooltip.203	\n{0} 컬러 보관
plw_itemtooltip.204	{0} 보관
plw_itemtooltip.205	({0}) Applied
plw_itemtooltip.206	Right Two Rows
plw_itemtooltip.207	Bottom Two Rows
plw_itemtooltip.208	Not Applied
plw_itemtooltip.209	\nExclusive Pet Pouch: {0}
plw_itemtooltip.210	정령 성장 보너스 : 정령 경험치 {0} (클래식 정령 제외)
plw_itemtooltip.211	\nPet Type: {0} / {1} / {2} / {3}
plw_itemtooltip.214	\nPet Adoption Info\nRace:
plw_itemtooltip.215	<color=1>Storage Count: {0}</color>\n
plw_itemtooltip.216	\nPet Food Buff Duration: {0}
plw_itemtooltip.217	Level: {0}\n\n
plw_itemtooltip.218	\nYou can burnish with Fynn Bead Burnishing skill {0} or higher.
plw_itemtooltip.219	\n{0} skill {1}
plw_itemtooltip.220	<color=1>Hourglass{0}: Remaining Time {1}</color>\n
plw_itemtooltip.221	Internal Name: Hourglass{0}\nLinked Item: {1}\nRemaining Time: {2}\n
plw_itemtooltip.222	Linked item cannot be found.
plw_itemtooltip.223	\nMax Summon Time: {0} hr {1} min
plw_itemtooltip.224	<color=3>Available</color>
plw_itemtooltip.225	<color=2>Unavailable</color>
plw_itemtooltip.226	Element: {0} {1}\n
plw_itemtooltip.227	Additional Inventory Window: 
plw_itemtooltip.228	None
plw_itemtooltip.229	x{0} ({1})
plw_itemtooltip.230	\nFriend Summon Slot: {0}\n
plw_itemtooltip.231	Fynn Sync Main: <color=3>Available</color>\n
plw_itemtooltip.232	Fynn Sync Sub: {0}\n
plw_itemtooltip.233	\n\nFynn Sync Info\n
plw_itemtooltip.234	Slot {0}: {1} {2}\n
plw_itemtooltip.235	Slot {0}: Empty\n
plw_itemtooltip.236	Slot {0}: Empty\n
plw_itemtooltip.237	Slot {0}: <color=2>Sealed</color>\n
plw_itemtooltip.238	\nFynn Bead Info\n
plw_itemtooltip.239	<color=3>Fynni Pet</color>\n
plw_itemtooltip.240	Fynn Sync Main: <color=2>Unavailable</color>\n
plw_itemtooltip.241	Fynn Sync Sub: <color=3>Available</color>\n
plw_itemtooltip.242	\n\nFynn Sync Info\n
plw_itemtooltip.243	Not a Fynn Pet yet.\n
plw_itemtooltip.244	Fynn Sync Main: {0}\n
plw_itemtooltip.245	Fynn Sync Sub: {0}\n
plw_itemtooltip.246	\n\nFynn Sync Info\n
plw_itemtooltip.256	Queue Total: {0} / Current Number: {1} [Your Number: {2}]
plw_itemtooltip.257	Item Color
plw_itemtooltip.258	(Flashy)
plw_itemtooltip.259	(Flashy)
plw_itemtooltip.260	Additional {0}% Fynni Gem Drop Rate upon successful Fynni Catching.\n
plw_itemtooltip.261	Acquire Exploration EXP equal to {0}% of production EXP upon successful Fynn Crafting.\n
plw_itemtooltip.bagexpander	<color=3>\nPouch Attached\n</color>
plw_itemupgrademgr.1	[Developer Use Message] Upgrade Method has disappeared.
plw_itemupgrademgr.2	{0}, the Royal Alchemist, has discovered a new Cylinder Upgrade Method.
plw_itemupgrademgr.3	A new Cylinder Upgrade Method has been discovered!
plw_joust.1	Opponent
plw_joust.2	\nReceived {0} Jousting Point(s).
plw_joust.3	The match will start in {0} seconds.\nPlease prepare to enter a command.
plw_joust.4	You've lost the match against {0}.
plw_joust.5	Enter a command.
plw_joust.6	You've been disqualified from the match.
plw_joust.7	Your entry into the Jousing Tournament has been canceled.
plw_mafiacomponent.1	Execute {0}?
plw_mafiacomponent.2	{0} has been saved from execution.
plw_mafiacomponent.3	There's no suspect to execute.
plw_mafiacomponent.4	Eliminated
plw_mafiacomponent.5	Cannot Vote
plw_mailboxcomponent.1	You need an additional {0} Gold for the fee. Please check the balance in your inventory.
plw_mailboxcomponent.2	You have successfully confirmed the character.
plw_mailboxcomponent.3	The mail was successfully sent to {0}.
plw_mailboxcomponent.4	This is a non-existing character. \nPlease check the name of the recipient one more time.
plw_mailboxcomponent.5	This cannot be sent to a pet character.
plw_mailboxcomponent.6	You cannot send this item to a character within the same account.
plw_mailboxcomponent.7	The selected character could not be found.
plw_mailboxcomponent.8	You cannot send mail to yourself.
plw_mailboxcomponent.9	You cannot send any mail because your inbox is full. Please accept your received mail and/or delete them.
plw_mailboxcomponent.10	You cannot send any mail because your outbox is full. Please wait until the recipients accept the pending mail.
plw_mailboxcomponent.11	You have already sent {1} pieces of mail to {0}. Please wait until {0} accepts the mail.
plw_mailboxcomponent.12	You cannot send any more mail to the recipient because the recipient's inbox is full. Please wait until the recipient accepts the pending mail.
plw_mailboxcomponent.13	You need additional Gold to pay for the processing fee. Please check the balance in your inventory.
plw_mailboxcomponent.14	You cannot sent any items that are currently being outfitted.
plw_mailboxcomponent.15	You have exceeded the maximum number of outgoing mail allowed.
plw_mailboxcomponent.16	You cannot mail this item.
plw_mailboxcomponent.17	You have failed to mail the item.
plw_mailboxcomponent.18	You do not have enough money in your bank account.
plw_mailboxcomponent.19	You do not have enough Gold in your inventory.
plw_mailboxcomponent.20	Your bank account is full and therefore you cannot make any more deposits.
plw_mailboxcomponent.21	This mail has already been recalled by the sender.
plw_mailboxcomponent.22	You have failed to confirm the recipient for the item's payment. 
plw_mailboxcomponent.23	You have failed to receive the mail.
plw_mailboxcomponent.24	This mail has already been recalled by the sender.
plw_mailboxcomponent.25	The sender's character has been deleted.
plw_mailboxcomponent.26	You have failed to confirm the sender.
plw_mailboxcomponent.27	You have failed to return the mail to the sender.
plw_mailboxcomponent.28	The recipient has received the item.
plw_mailboxcomponent.29	Unable to recall the mail from the recipient.
plw_mailboxcomponent.30	Try again in {0} sec.
plw_mailboxcomponent.31	GM mail cannot be ㅣreturned.
plw_marinagateprop.1	Get off the raft
plw_marinagateprop.2	Get on the raft
plw_minigamecomponent.1	Unable to start the mini-game.
plw_minigameprop.1	Mafia game in progress.\n
plw_minigameprop.2	Party: {0}\n
plw_minigameprop.3	Leader: {0}\n
plw_minigameprop.4	Players: {0}\n
plw_minigameprop.5	Spectators: {0}\n
plw_minimapmgr.1	Altruist Location
plw_minimapmgr.2	This feature can't be used right now.
plw_myknights.1	Waiting
plw_myknights.2	Mission in Progress
plw_myknights.3	Mission Complete
plw_myknights.4	Training
plw_myknights.5	Training Complete
plw_myknights.6	Resting
plw_myknights.7	Has gone out
plw_myknights.8	Injured
plw_myknights.9	{0} is on the {1} mission.
plw_myknights.10	Notice
plw_myknights.11	{0} has declined the mission.
plw_myknights.14	Not enough Likeability.
plw_myknights.15	Not enough Training Points.
plw_myknights.16	{0}'s training cannot begin.\n{1}
plw_myknights.18	{0}'s training cannot be canceled.
plw_myknights.19	Training Complete
plw_myknights.20	 Their specialty!!
plw_myknights.21	 Going out!!
plw_myknights.22	!
plw_myknights.23	Reasons training went well:{0}
plw_myknights.25	{0}'s training could not be completed.
plw_myknights.26	You cannot move while mounted.
plw_myknights.27	You cannot move if you have a summoned creature.
plw_myknights.28	You cannot move while trading.
plw_myknights.29	You cannot move while mounted.
plw_myknights.30	You cannot move while talking to an NPC.
plw_myknights.31	You cannot move while trading.
plw_myknights.32	You cannot move in combat.
plw_myknights.33	You cannot move in PvP.
plw_myknights.34	You cannot move while using a skill.
plw_myknights.35	You cannot move at this time.
plw_myknights.36	Invalid mission has been completed.
plw_myknights.37	Report mission success
plw_myknights.38	Report mission failure
plw_myknights.39	\nSquire was injured while on a mission.
plw_myknights.40	Mission canceled.
plw_myknights.41	The mission cannot begin.\n
plw_myknights.42	{0}'s training will begin.
plw_myknights.43	{0}'s training was canceled.
plw_myknights.44	The mission has been completed.\nYou cannot complete it instantly.
plw_myknights.45	You cannot move while playing a Festia mini-game or attraction.
plw_naorespawnservice.1	퍼거스의 대장간!! 믿고 맡길 수 있는 여러분의 친구라오~ 쿠하하하.
plw_naorespawnservice.2	<npcportrait name=\"ferghus\"/><title name=\"퍼거스\"/>이크. 발이 미끄러졌네...<p/><npcportrait name=\"ferghus\"/><title name=\"퍼거스\"/>흠... 보아하니 댁도 여기저기 원한을 많이 산 것 같은데<br/>나처럼 착하게 사시구려.<br/>쿠하하하.<p/><npcportrait name=\"ferghus\"/><title name=\"퍼거스\"/>앗. 이건 나를 애타게 찾는 목소리?!!<br/>빨리 대장간으로 돌아가야겠구려.<br/>그럼, 그 쪽도 조심하시오~~
plw_newegoweapon.1	Can use the {0} skill.
plw_newegoweapon.2	You received a Teardrop of the Spirit.
plw_newegoweapon.3	You've already received a Teardrop of the Spirit today.
plw_newegoweapon.4	There is no room in your inventory for the Teardrop of the Spirit.
plw_newegoweapon.5	{1} of {0}
plw_newegoweapon.6	You already received a Teardrop of the Spirit today.
plw_newegoweapon.7	<title name='NONE'/><face name='normal'/>(Select a Keyword and talk to the Spirit.)
plw_newegoweapon.8	<title name='NONE'/><face name='normal'/>(Select a Keyword and talk to the Spirit.)
plw_partymgr.1	Party formation is forbidden here.
plw_partymgr.2	Cannot open the party window here.
plw_partymgr.3	[{1}, Unit {0}] {2}
plw_partymgr.4	You've created a squad.
plw_partymgr.5	You left the squad.
plw_partymgr.6	You were kicked out of the squad.
plw_partymgr.7	{0} joined the squad.
plw_partymgr.8	{0} left the squad.
plw_partymgr.9	{0} is now the Captain of the squad.
plw_partymgr.10	{0} has been appointed to Lieutenant.
plw_partymgr.11	{0} has been changed to a general member.
plw_partymgr.12	Squad recruitment started.
plw_partymgr.13	Squad recruitment ended.
plw_partymgr.14	{0} set the squad's finish rules to [{1}].
plw_partymgr.15	{0} set the squad's EXP distribution rules to [{1}].
plw_partymgr.16	Member
plw_partymgr.17	Lieutenant
plw_partymgr.18	Captain
plw_partymgr.19	{0} changed the squad mission to [{1}].
plw_partymgr.20	{0} canceled the squad mission.
plw_partymgr.21	Characters cannot do that while in the tutorial.\n(Available after first Rebirth)
plw_partymgr.22	You cannot form a party while on a Festia waiting list.
plw_partymgr.23	You cannot form a party while playing in Festia.
plw_partymgrmsg.1	You cannot kick party members out right now.
plw_partymgrmsg.2	Moved successfully.
plw_partymgrmsg.3	Calling all squad members to arms... 
plw_partymgrmsg.4	The Captain has called all members to arms. Are you ready for battle? 
plw_partymgrmsg.5	The following squad members are not ready:\n{0}
plw_partymgrmsg.6	All squad members are ready.
plw_partymgrmsg.7	Requesting all squad members relocate to {0}...
plw_partymgrmsg.8	The Captain has requested the squad move to {0}. Are you ready to move? 
plw_partymgrmsg.9	No matching squads found. A new squad will be created.
plw_partymgrmsg.10	You failed to create and join a squad.
plw_partymgrmsg.11	You cannot be matched while you are in a squad.
plw_partymgrmsg.12	The following squad members are not ready: \n{0}
plw_partymgrmsg.13	Appoint Lieutenant
plw_partymgrmsg.14	Failed to join because the party information has changed.
plw_partymgrmsg.15	If you want to join {0} ({1})'s party, {2}, you need to move to a different channel.\n Do you want to move now?
plw_partymgrmsg.16	Sorry, this party is full.
plw_partymgrmsg.17	You cannot leave the party right now.
plw_personalshop.1	Unable to close the Personal Shop.
plw_personalshop.2	Kiosk not installed.
plw_personalshop.3	A Kiosk has been installed in {0}.
plw_personalshop.4	A Kiosk has been installed.
plw_personalshop.5	The items in your Kiosk have been tidied.
plw_personalshop.6	You cannot set prices while using skills.
plw_personalshopcustomer.1	{0} of {1}
plw_personalshopcustomer.2	That item does not exist.
plw_personalshopcustomer.3	Corresponding item does not exist.
plw_personalshopcustomer.4	Corresponding item does not exist.
plw_personalshopcustomer.5	You cannot purchase your own goods.
plw_petexpedition.1	Too many expeditions are currently in progress.\nPlease see to any completed ventures.
plw_petexpedition.2	A pet that is currently unconscious is currently assigned to the expedition that's about to launch.\nHeal the pet before proceeding with the expedition.
plw_petexpedition.3	A pet that is presently summoned is currently assigned to the expedition that's about to launch.\nUn-summon the pet before proceeding with the expedition.
plw_petexpedition.4	A pet that is pending deletion is currently assigned to the expedition that's about to launch.\nCancel the pet's deletion before proceeding with the expedition.
plw_petexpedition.5	Pets resting at the Pet House or already assigned to another expedition cannot be selected.
plw_petexpedition.6	A pet with excessively high Fatigue is currently assigned to the expedition that's about to launch.
plw_petexpedition.7	The selected pet cannot take part in expeditionary ventures.
plw_petexpedition.8	Cannot be completed because an expeditionary venture is still in progress.
plw_petexpedition.9	Cannot be canceled because the expeditionary venture is finished. Please complete the venture.
plw_petexpedition.10	Please try inside the Homestead.
plw_petexpedition.11	An unknown error has occurred.
plw_petexpedition.12	The expedition completed the {0} expedition and returned to the Homestead.
plw_petexpedition.13	Please complete the expedition after emptying your temporary inventory.
plw_petexpedition.14	A pet that has never been summoned before is currently assigned to the expedition that's about to launch.\nSummon the pet once before proceeding with the expedition.
plw_petmgr.1	Training EXP effect for the {0} talent was applied to the pet.
plw_petmgr.2	This talent is not supported.
plw_petmgr.3	The Blooming Nostalgia effect was not applied because the pet was de-summoned.
plw_petmgr.4	This pet already has a Support talent set.
plw_petmgr.5	This pet cannot use the Blooming Nostalgia skill.
plw_petmgr.6	Failed because you do not own this pet.
plw_petspecialtalentcomponent.1	Are you sure you want to rebirth?\n\n<color=6><outlinecolor=3>You currently have no perks learned\nYou can obtain a perk\nif you rebirth after reaching level 100.</outlinecolor></color>\n
plw_petspecialtalentcomponent.2	Are you sure you want to rebirth?\n\n<color=6><outlinecolor=3>This pet cannot learn any perks.</outlinecolor></color>\n
plw_petspecialtalentcomponent.3	Confirm Rebirth
plw_petspecialtalentcomponent.4	Cannot rebirth. No pet summoned.
plw_petspecialtalentcomponent.5	Rebirth failed.\nPlease try again later.
plw_pfhousingcomponent.1	Furniture successfully placed
plw_pfhousingcomponent.2	Failed to place Furniture
plw_pfhousingcomponent.3	Furniture successfully removed
plw_pfhousingcomponent.4	Failed to remove Furniture
plw_pfhousingcomponent.5	Successfully retrieved or removed all Furniture.
plw_pfhousingcomponent.6	Some Furniture could not be retrieved or removed.
plw_pfhousingcomponent.7	Homestead House successfully leased
plw_pfhousingcomponent.8	Failed to alter lease, because your Premium Service period has ended.
plw_pfhousingcomponent.9	Failed to lease due to insufficient Gold.
plw_pfhousingcomponent.10	Failed to lease.
plw_pfhousingcomponent.11	You'll need to expand your house to use Camps or Igloos.
plw_pfhousingcomponent.12	You can't perform a Direct Bank Transaction right now.
plw_pfhousingcomponent.13	You can't perform a Direct Bank Transaction right now.
plw_pfhousingcomponent.14	You successfully extended your lease.
plw_pfhousingcomponent.15	Failed to alter lease, because your Premium Service period has ended.
plw_pfhousingcomponent.16	Failed to extend lease due to insufficient Gold.
plw_pfhousingcomponent.17	Failed to lease.
plw_pfhousingcomponent.18	You can't extend your lease right now.
plw_pfhousingcomponent.19	You can't perform a Direct Bank Transaction right now.
plw_pfhousingcomponent.20	You can't perform a Direct Bank Transaction right now.
plw_pfhousingcomponent.21	Too much time has passed. Please try again.
plw_pfhousingcomponent.22	You'll need to expand your house to use Camps or Igloos.
plw_pfhousingcomponent.23	You can't enter into a lease if you have 2 or more houses in your Homestead.
plw_pfhousingcomponent.24	The room has been opened, and is now available for use.
plw_pfhousingcomponent.25	An unknown error has occurred.
plw_pfhousingcomponent.26	This room has already been opened.
plw_pfhousingcomponent.27	You can't afford the construction fees.\nYou need the following materials to open the room.\n\n{0}
plw_pfhousingcomponent.28	You can't afford the construction fees.
plw_pfhousingcomponent.29	You can't open it yet.
plw_pfhousingcomponent.30	Started research on {0}.
plw_pfhousingcomponent.31	Completed research on {0}.
plw_pfhousingcomponent.32	Canceled research on {0}.
plw_pfhousingcomponent.33	{0} effect activated.
plw_pfhousingcomponent.34	You can't upgrade a workshop bench while a research task is in progress.\nComplete or stop the research first.
plw_privatefarm.1	Failed to exit Homestead.
plw_privatefarm.2	Unable to delete.
plw_privatefarm.3	Not enough materials.
plw_privatefarm.4	Unable to plant.
plw_privatefarm.5	You've created a Homestead. You can move to your Homestead by using the Homestead menu.
plw_privatefarm.6	An unknown error has occurred.
plw_privatefarm.7	A Homestead already exists.
plw_privatefarm.8	Incorrect theme selected.
plw_privatefarm.9	Name already in use.
plw_privatefarm.10	An error has occurred while creating a Homestead. Please try again.
plw_privatefarm.11	Error
plw_privatefarm.12	Homestead expansion failed.\nPlease exit the Homestead and enter again.
plw_privatefarm.13	You've entered the Homestead.
plw_privatefarm.14	You've exited the Homestead.
plw_privatefarm.15	{0} of Homestead completed.
plw_privatefarm.16	Guide
plw_privatefarm.17	You've successfully made a Homestead visitation request.
plw_privatefarm.18	Guide
plw_privatefarm.19	Visitation request has failed.\nPlease try again later.
plw_privatefarm.20	Guide
plw_privatefarm.21	You are not authorized to visit this Homestead.\nWould you like to make a visitation request?
plw_privatefarm.22	Error
plw_privatefarm.23	You've been moved outside because the Homestead has changed.
plw_privatefarm.24	You have been expelled from the Homestead.
plw_privatefarm.25	NA
plw_privatefarm.26	NA
plw_privatefarm.27	Kon
plw_privatefarm.28	Kon
plw_privatefarm.29	You've created a Homestead. You can move to your Homestead by using the Homestead menu {0}.
plw_privatefarm.30	The Homestead is no longer limited to certain channels.\nYou can now enter from any channel.
plw_privatefarm.31	The Homestead is now limited to certain channels.\nYou can only enter from {0}.
plw_privatefarm.32	We were unable set a fixed channel for the Homestead.
plw_privatefarm.33	\nPlease try again after {0}.
plw_privatefarm.34	{0}\nGo to {1} and enter?\n\n
plw_privatefarm.35	{0} Homestead Stone(s) have been paid as upkeep.\n{1} Homestead Stone(s) remain.
plw_privatefarm.36	You don't have enough stones for upkeep, so your Homestead will be penalized.
plw_privatefarm.37	You do not have enough items to lift the penalty.
plw_privatefarm.38	The penalty was removed.
plw_privatefarm.39	An error has occurred. Please try again in a moment.
plw_privatefarm.40	Not enough Pon.
plw_privatefarm.41	An error has occurred. Please try again in a moment.
plw_privatefarm.42	The farm is being created by a different character. Please try again later.
plw_privatefarm.43	You don't have enough Homestead Stones.
plw_privatefarm.44	Name already in use.
plw_privatefarm.45	Make {0} grow?
plw_privatefarm.46	\n<color=5>[</color><color=2>Required material</color><color=5>]</color>
plw_privatefarm.47	This house can't be removed, because there is still furniture left inside.
plw_privatefarm.48	{0} has entered \nyour Homestead.
plw_privatefarm.49	{0} has left \nyour Homestead.
plw_privatefarm.50	You have entered the Homestead House.
plw_privatefarm.51	This house can't be removed, because there are still visitors inside.
plw_privatefarm.52	The Owner has asked you to leave.
plw_privatefarm.53	This item is not available for bulk retrieval.\n
plw_privatefarm.54	Bulk retrieval was successful, aside from the following Props, which cannot be moved via bulk retrieval.\n
plw_privatefarm.55	Bulk retrieval was successful.
plw_privatefarm.56	Would you like to retrieve these housing items?
plw_privatefarm.57	This housing item cannot be selected in multiples.
plw_privatefarm.58	Multiple selection is not available for fields with farm products. Please harvest your produce first.
plw_privatefarm.59	You cannot retrieve more than {0}.
plw_privatefarm.60	Included is a housing item that requires the consumption of Homestead Stones to be removed.\nA total of {0} Homestead Stone(s) will be consumed, and this will be changed to a housing item.\nYou can install it again by using the housing item.\nDo you really want to remove it?
plw_privatefarm.61	Temporary Inventory must be empty in order to proceed with bulk retrieval.
plw_privatefarm.62	Houses in which pets are resting cannot be multi-selected. Have the pet finish or pause their rest first.
plw_privatefarm.63	Rest is not available for this pet type.
plw_privatefarm.64	This pet is already resting or on an expedition.
plw_privatefarm.65	This pet is not resting.
plw_privatefarm.66	This pet can finish its rest.
plw_privatefarm.67	This pet's rest cannot be finished; the required resting duration has not yet been met.
plw_privatefarm.68	Summoned pets cannot be selected to rest.\nPlease de-summon the pet, then press the 'Start Resting' button again.
plw_privatefarm.69	Unconscious pets cannot be selected to rest.\nPlease heal the pet, then press the 'Start Resting' button again.
plw_privatefarm.70	Pets pending deletion cannot be selected to rest.\nPlease cancel the deletion of the pet, then press the 'Start Resting' button again.
plw_privatefarm.71	An unknown error has occurred.
plw_privatefarm.72	{0} has finished resting at the Homestead Pet House.
plw_privatefarm.73	Blossoming {0}
plw_privatefarm.74	Blossoming Cages cannot be selected in multiples while blossoming is in progress. Please try again after blossoming is complete.
plw_privatefarm.75	You can't command a pet that's never been summoned before to rest.\nClick the [Start Resting] button again after you've summoned the pet at least once.
plw_privatefarmrankingmgr.1	Currently requesting... Try again later.
plw_privatefarmzone.1	You can enter from any channel.
plw_privatefarmzone.2	You can only enter from the current channel.
plw_propeffect.1	{0}\n({1} sec, {2}m)
plw_propeffect.2	{0}\n({1} sec, {2}m)
plw_propeffect.3	{0} - {1} Points!
plw_pvpdescmgr.1	Failed to compile the rankings.
plw_pvpdescmgr.2	See Ranking
plw_pvpdescmgr.3	Failed to compile the rankings.
plw_pvpdescmgr.4	See Ranking
plw_pvpmgr.1	You can't change settings on the "Allow Elf vs. Giant PVP" option for 3 minutes.
plw_pvpmgr.2	The PVP option for Paladins and Dark Knights cannot be reset for 3 minutes.
plw_pvpmgr.3	You can't change the settings on the PVP option for 3 minutes.
plw_quest.1	Expired
plw_quest.2	Expired
plw_questcomponent.1	You can't finish missions while you're on ladders.
plw_questcomponent.2	You cannot leave in the middle of a mini-game.
plw_relationmgr.1	Message added.
plw_relationmgr.2	Error occurred during transmission.
plw_relationmgr.3	Failed to register screen shot.
plw_relationmgr.4	Failed to register screen shot.\nNo response.
plw_relationmgr.5	Error occurred during transmission.
plw_relationmgr.6	{0} year(s) ago
plw_relationmgr.7	{0} month(s) ago
plw_relationmgr.8	{0} day(s) ago
plw_relationmgr.9	{0} hour(s) ago
plw_relationmgr.10	{0} minute(s) ago
plw_relationmgr.11	A moment ago
plw_relationmgr.12	Received treatment.
plw_relationmgr.13	You performed \nFirst Aid on them.
plw_relationmgr.14	Received First Aid \nfrom you.
plw_relationmgr.15	Revived you.
plw_relationmgr.16	You revived them.
plw_relationmgr.17	Mounted a pet.
plw_relationmgr.18	Aided you with \nyour help request.
plw_relationmgr.19	You answered their \nhelp request.
plw_relationmgr.20	Traded goods.
plw_relationmgr.21	Delivered to them a package \nvia the bank delivery part-time job.
plw_relationmgr.22	Received a bank delivery \nfrom them.
plw_relationmgr.23	Cleared a party quest \ntogether.
plw_relationmgr.24	Started a dungeon \ntogether.
plw_relationmgr.25	Cleared a dungeon \ntogether.
plw_relationmgr.26	Started a shadow mission \ntogether.
plw_relationmgr.27	Cleared a shadow mission \ntogether.
plw_relationmgr.28	Entered Renes \ntogether.
plw_relationmgr.29	Defended Renes's Egg \ntogether.
plw_relationmgr.30	Rode a raft together.
plw_relationmgr.31	Rode a hot air balloon together.
plw_relationmgr.32	Defeated a field boss \ntogether.
plw_relationmgr.33	Shared food around \na campfire.
plw_relationmgr.34	Performed together.
plw_relationmgr.35	Participated in a\nFashion Show together.
plw_relationmgr.36	Poured rain on \nyou.
plw_relationmgr.37	Was together at \nthe camp.
plw_relationmgr.38	Was in a jousting \ntournament together.
plw_relationmgr.39	Fought a PVP battle \ntogether.
plw_relationmgr.40	Was in a pet battle.
plw_relationmgr.41	Took the Advancement\nTest together.
plw_relationmgr.42	Sent whisper.
plw_relationmgr.43	\n({0} times)
plw_relationmgr.44	Please try again later.
plw_reputationcomponent.1	From {0} 
plw_reputationcomponent.2	Renown has increased by %.1f.
plw_reputationcomponent.3	Renown from {0}
plw_rockpaperscissorscomponent.1	The opponent has refused to play Rock Paper Scissors with you.
plw_rockpaperscissorscomponent.2	{0} requested a match of Rock Paper Scissors with you. Do you accept?
plw_rockpaperscissorscomponent.3	You do not have any Match Tickets to use.
plw_scrapbook.1	Successfully registered.
plw_scrapbook.2	Another chef has registered a better dish.
plw_scrapbook.3	The phrase includes a term that is deemed inappropriate.
plw_scrapbook.4	There are no comments.\nEnter a comment:
plw_scrapbook.5	Failed to save.\nPlease try again.
plw_scrapbook.6	Failed to register.
plw_senmagbattleground.1	Sen Mag Battleground
plw_senmagbattleground.2	You have completed your sign-up to participate in a Guild Battle.\nWould you like to go to the battleground?
plw_senmagbattleground.3	Go to Battleground
plw_senmagbattleground.4	Go to Sen Mag
plw_senmagbattleground.5	Cancel
plw_servicemgr.1	{0} is required to open the bag.\nPlease use 'Empty Bag' command to retrieve the items in the bag.
plw_servicemgr.2	Your {0} session has expired, and all your open bags have been locked.\nPlease use 'Empty Bag' command to retrieve the items in the bag.
plw_servicemgr.3	You are currently not using {0}.\n{1} is required to retrieve locked items.
plw_servicemgr.4	You are currently not using {0}.\n{1} is required to store items in the locked area.
plw_servicemgr.5	You are currently not using {0}.\nAny purchased bags cannot be used.
plw_servicemgr.6	A Guild is a system which utilizes additional resources from the Guild website,\nand the Guild Leader MUST use {0}.\n\nIf the Leader does not use {1},\nthe Guild-related services may be temporarily blocked.\n{2} does not apply to the members of the Guild.\n
plw_servicemgr.7	{0} is required to open a Personal Shop.
plw_servicemgr.8	Cannot use the shop functions\nwithout {0} in effect
plw_servicemgr.9	It's your birthday! Would you like to receive your birthday gift Nao prepared just for you?
plw_shapeshift.1	<color=3>Cannot Transform</color>
plw_shapeshift.2	<color=3>Cannot Transform</color>
plw_shapeshift.3	<color=4>Complete</color>
plw_shapeshift.4	<color=2>Unavailable</color>
plw_shapeshift.5	Unable to use during Crisis Escape.
plw_showdown.1	The match has been canceled.
plw_showdown.2	The battle will now begin.
plw_showdown.3	Start!
plw_showdown.4	The match cannot be proceeded.
plw_showdown.5	You may not request a match right now.
plw_showdown.6	파티 리더가 파티 대전 신청을 했습니다.
plw_showdown.7	파티 리더가 파티 대전 초대를 받았습니다.
plw_showdown.8	파티 리더가 파티 대전 신청을 거절했습니다.
plw_showdown.9	파티 대전에서 탈락하였습니다.
plw_skiing.1	Jump Distance: {0} meter\nStyle Points: {1} point(s)\nTotal: {2} point(s)
plw_skiing.2	{0} m\n{1} pts\n{2} pts
plw_skiing.3	Jump Distance\nStyle Points\nTotal
plw_skillmgr.1	Cannot be used at Rank 1 or above.
plw_skillmgr.2	You cannot use the item.\nIts minimum rank is {0}.
plw_skillmgr.3	Cannot be used at {0} or above.
plw_skillmgrmsg.1	You cannot perform certain actions when you're so small.
plw_skillmgrmsg.2	중독 방지 중에는 불가합니다.
plw_soulmatecomponent.1	Dance time results!\n\n
plw_soulmatecomponent.2	[{0}] - {1} points\n
plw_soulmatecomponent.3	[{0}] - {1} points\n
plw_soulmatecomponent.4	\n{0} points total!
plw_soulmatecomponent.5	It's time to dance! \nStarting now, your movements will be restricted.\nStart?
plw_soulmatecomponent.6	Soulmate
plw_soulmatecomponent.7	I can't be matched with a soulmate right now.
plw_soulmatecomponent.8	You're too far away.
plw_soulmatecomponent.9	Your love interest can't be matched with a soulmate right now.
plw_soulmatecomponent.10	{0} has a crush on you!\nAccept?
plw_soulmatecomponent.11	Soulmate
plw_soulmatecomponent.12	Your advances were denied!
plw_soulmatecomponent.13	{0} wants to fly with you. Accept?
plw_soulmatecomponent.14	Soulmate
plw_specialization.1	Set {0} saved.
plw_specialization.2	The Techniques from set {0} have been activated.
plw_specialization.3	{0} increased by {1}.
plw_specialization.4	All sets have been saved.
plw_summonmaster.1	You cannot summon this pet while you are mounted.
plw_summonmaster.2	You cannot cancel unsummon a pet while using a skill.
plw_summonmaster.3	You cannot cancel your summon while in a conversation with your partner.
plw_summonmaster.4	This is a Field Quest zone where pets or partners cannot be summoned.
plw_summonmaster.5	This service is currently unavailable.
plw_summonmaster.6	This is the wrong item.
plw_summonmaster.7	Already summoned.
plw_summonmaster.8	You don't have enough summon slots.
plw_summonmaster.9	This doesn't have a name.
plw_summonmaster.10	Invalid client for summon request.
plw_summonmaster.11	No space to summon.
plw_summonmaster.12	Failed to summon.
plw_summonmaster.13	You don't have enough summon slots.
plw_summonmaster.14	You've used all of the summon time for today.
plw_summonmaster.15	Cannot be summoned at this time.
plw_summonmaster.16	Unknown cause {0}.
plw_summonmaster.17	Failed to summon.\n{1}
plw_summonmaster.18	
plw_summonmaster.19	Failed to cancel the summon.
plw_summonmaster.20	Fail to set a name.
plw_summonmaster.21	This service is currently unavailable.
plw_summonmaster.22	This is the wrong item.
plw_summonmaster.23	Already named.
plw_summonmaster.24	You cannot summon a pet or partner while using the Dressing Room.
plw_summonmaster.25	You cannot change channels while using the skill.
plw_summonmaster.26	You cannot change channels while talking to a Partner.
plw_summonmaster.27	You cannot change channels right now. Try again later.
plw_summonmaster.28	Phantom's Roar prevents you from summoning your pet or a partner.
plw_summonmaster.30	You cannot summon a Pet or Partner right now.
plw_summonmaster.31	Pets without summon skills cannot be registered to a Friend Summon slot.
plw_summonmaster.32	You have exceeded the maximum number of Fynn Pet quickslots.
plw_summonmaster.33	You have no pets to register.
plw_summonmaster.34	You have no Fynn Pets to register.
plw_summonmaster.35	Pets without summon skills cannot be registered to a Friend Summon slot.
plw_summonmaster.36	You cannot register beyond the maximum number of quickslots.
plw_summonmaster.37	You have no pets to register.
plw_summonmaster.38	Cannot register without pet skills.
plw_summonmaster.39	You cannot summon other pets during Fynn Sync.
plw_summonmaster.40	Pets that are on an expedition or resting cannot be registered to the Friend Summon slot.
plw_summonmaster.41	Friend Summon changing is only available once a day (Erinn time) for each slot.\n(Can change after 06:00 Erinn time.)
plw_summonmaster.42	This pet is already registered to a Friend Summon slot.
plw_summonmaster.43	Summoned pets cannot be registered to a Friend Summon slot.
plw_summonmaster.44	Friend Summon changing is only available once a day (Erinn time) for each slot.\n(Can change after 06:00 Erinn time.)
plw_supportpuppetcomponent.1	Restricted from using because appearance has changed.
plw_supportpuppetcomponent.2	The Shield has been activated.
plw_supportpuppetcomponent.3	The Shield has been deactivated.
plw_tabletalkpanelprop.1	You can change the theme.
plw_tabletalkpanelprop.2	You can change {0:n minutes and m seconds}.
plw_tabletalkpanelprop.3	You can't change another person's theme.
plw_talent.1	You haven't acquired any Talents yet.\nObtain Talents by ranking up your skills.
plw_talent.2	Use the {0} Talent Title.
plw_talent.3	You cannot use this Talent Title.
plw_talent.4	You can change your Talent Title once a day.
plw_talent.5	You don't have enough AP to change the Unique Effect.
plw_tame.1	The Golem is too far away to be controlled.
plw_trademgrmsg.1	Another player's Trade Inventory has been expanded already.
plw_trademgrmsg.2	Insufficient gold.
plw_trademgrmsg.3	Failed to pay your funds.
plw_trademgrmsg.4	Insufficient funds. You have sufficient funds in your account, but your access has been restricted at the moment.
plw_trademgrmsg.5	You've entered an incorrect bank password.
plw_trademgrmsg.6	You failed to deposit money in your bank account.
plw_trademgrmsg.7	Clear out your temporary inventory and try again.
plw_transportcomponent.1	If you ride the hot air balloon right now, all your stars will disappear.\nYou can receive the reward for stars by taking them to Kelpie.\n\nDo you still wish to ride it right now?
plw_transportcomponent.2	Do you wish to get on the hot air balloon?
plw_transporterpart_crossbow.1	A Ballista that you can use to attack enemies from afar. In order to use this Ballista, you'll need Ballista Bolts.
plw_transporterpart_crossbow.2	I don't believe I can use it because I don't have a Ballista Bolt.
plw_transporterpart_crossbow.3	I don't believe I can use the Ballista if I'm holding something in my hands.
plw_transporterpart_crossbow.4	This ballista can be used to attack far away enemies.
plw_transporterpart_engine.1	You can reinforce the lift of the hot air balloon by putting flints inside the hot air balloon's burner. 
plw_transporterpart_engine.2	I'm not holding a flint.
plw_transporterpart_engine.3	I'm not holding a flint.
plw_transporterpart_engine.4	You can't use it because there's not enough fire power to burn the flint.
plw_transporterpart_engine.5	The hot air balloon is losing its lift and it seems like it's going to crash.\nYou need to put flint inside the burner to reinforce its lift.
plw_transporterpart_flycontroller.1	The key for controlling the hot air balloon. When you grab the key, a private window will open and you will be able to control the take off and landing as well as the direction of the hot air balloon. 
plw_transporterpart_flycontroller.2	You can't use the way point to select areas you cannot travel to.
plw_transporterpart_flycontroller.3	This Hot-Air Balloon doesn't require controlling.
plw_treasureofgod.1	Restoration failed.
plw_treasureofgod.2	Restoration successful!
plw_turret.1	You cannot switch to Aiming mode while holding an item.
plw_turret.2	\nWill be set to Cursor mode.
plw_turret.3	Changed to Cursor mode.
plw_turret.4	Changed to Aiming mode.
plw_vehicle.1	Movement Speed has increased.
plw_vehicle.2	Cannot receive the Movement Speed buff from your Partner.
plw_vehicle.3	The Movement Speed buff effect has faded.
plw_vehicle.4	{0} wants to fly with you. Accept?
plw_vehicle.5	Fly Together
plw_weathermgr.1	It is snowing.
plw_weathermgr.2	It is snowing.
plw_weathermgr.3	It has stopped snowing.
plw_weathermgr.4	It is snowing.\tYou can collect more items from nature and animals.\tSuccess rate for fishing and production skills will increase.\tThe duration of a campfire will decrease.
plw_worldmsg.1	{0} has summoned {1} to {2}.
plw_worldmsg.2	{0} has summoned {1}.
plw_worldmsg.3	Would you like to return to\nthe dungeon? (You will be\nmoved to the dungeon's channel.)
plw_worldmsg.4	Return to Dungeon
plw_worldmsg.5	The time limit for reentry has run out.
plw_worldmsg.6	That dungeon has been completed.
plw_worldmsg.7	Failed to rejoin the party. You are unable to enter.
plw_worldmsg.8	Failed to switch channels. You are unable to enter.
plw_worldmsg.9	You attempted to enter the dungeon abnormally. You are unable to enter.
plw_worldmsg.10	Entries Left: {0}
plw_worldmsg.11	You've used up all your entries. You can no longer enter this dungeon.
plw_worldmsg.13	{0}: {2}'s Freestyle Jam in the {1} area has received the Blessing of Cairbre.
plw_worldmsg.14	{0}: The Blessing of Cairbre has disappeared from the {1} area.
plw_worldmsg.15	{0}: {2} mins of the Blessing of Cairbre left in the {1} area.
szconditiondurationuphandler.1	Iron Will
szconditiondurationuphandler.2	Relentless Assault
szconditiondurationuphandler.3	Vital Surge
szconditiondurationuphandler.4	Exploit Weakness
szconditiondurationuphandler.5	You can use the skill {0} for another 10 sec.
szconditionhandler.1	Iron Will
szconditionhandler.2	Time Shift
szconditionhandler.3	Relentless Assault
szconditionhandler.4	Vital Surge
szconditionhandler.5	Exploit Weakness
szconditionhandler.6	You can use the skill {0} for another 10 sec.
unlockweaponpower.1	Tyrfing has awakened by absorbing {0}'s life.
unlockweaponpower.2	The rage of Tyrfing has been quelled.
web.avatar_file	/avatarupload_2.asp
web.avatar_server	http://avatar.mabinogi.com
web.livescr_file	/live/liveupload.asp
web.livescr_server	http://avatar.mabinogi.com
web.ui_url	http://avatar.mabinogi.com/ui/
window.ask_burn_item_enchant	Do you wish to burn {0}?\nYou will be rewarded with either some EXP and an item, or an Enchant Scroll and a Magic Powder.
window.ask_burnup_item	Do you wish to burn {0}?\nYou will get some EXP and an item.
window.ask_expensive_drop	This is an expensive item. Do you want to continue?\n\n(This can be disabled through Option under Others.)
window.ask_give_item	Do you wish to give {1} to {0}?\nPlease be aware that gift items cannot be reclaimed.
window.ask_item_drop	Do you wish to drop the item?
window.blacksmith.making_points	Marker is being set.
window.burn_entrust_name	Entrust Others to Burn
window.burnup_item_enchant_notenough_material	Do you wish to burn {0}?\nYou will get some EXP and an item.\nYou will need Mana Herb and Holy Water of Lymilark to extract the enchant.
window.burnup_item_enchant_title	Enchanter's Burn
window.burnup_item_title	Burn
window.chronicle_view.timesort_dsc	From oldest
window.friends_in_offline_state	Friends Offline
window.friends_online_state	Friends Online
window.lobby_character_select_title	Select Your Character
window.msg_item_age0	Only characters between {0} and {1} years old may equip this item.
window.msg_item_age1	Only characters over {0} years old may equip this item.
window.msg_item_age2	Only characters under {0} years old may equip this item.
window.pet.rebirth	<large>Rebirth Pet</large>
window.pet.title.new	Create a New Pet
window.production.essential_party_1	Required Materials (Makes up to <color=2>{0}</color><mini>({1})</mini>%) <color=2>(Party Bonus)</color>:
window.production2.available_count	Max Available: {0}
window.production2.essential_party	Success Rate: <color=2>{0}</color><mini>({1})</mini>% <color=2>(Party Bonus Enabled)</color>
window.production2.skill_level	Current Skill Level: {0}
window.production2.successrate	Success Rate: {0}%
window.title.rebirth	The character is being reborn.
window.weather.clear	The sky's clearing up.
window.weather.cloudy	It's getting cloudy here.
window.weather.rainy	It's raining.
window.weather.rainy2	It's raining.
window.weather.rainy_help_caption	It's raining.\tIncrease in item drop rate for animals and nature.\tIncrease in success rate for fishing and Production skills.\tDuration of Campfire is decreased.
window.weather.stop_raining	The rain has stopped.
mabinogimain.3	취소
mabinogimain.5	불편을 끼쳐드려 대단히 죄송합니다.
mabinogimain.7	MabinogiKorea
pleioneglobalconsole.3	테스트 스트링
pleionelogin.47	게임이용이 차단됩니다. (코드 : {0})
plw_item.100	{0} {1}
plw_item.101	{0} {1}
plw_item.102	{0} {1}
plw_item.103	{0} {1}
plw_item.104	{0} {1}
plw_item.105	{0} {1}
plw_item.106	{0} {1}
plw_item.97	{0} {1}
plw_item.99	{0} {1}
